Wo, Wo, Ww, Ww, Gs, Gs, Gs, Gs, Gs, Re, Re, Gs^Fds, Gs, Gs^Fds, Gs^Fds, Gs, Gg, Hh^Fds, Hh^Fds, Hh^Fds, Mm, Mm, Mm, Mm, Mm, Hh, Mm, Mm, Mm, Mm, Mm, Mm, Mm, Mm, Mm, Mm, Mm
Wo, Wo, Ww, Ww, Gs^Vh, Gs, Gs, Gs, Gs, Re, Re, Gs^Fds, Gs, Gs^Fds, Gs^Fds, Gs, Gg^Vh, Hh^Fds, Hh^Fds, Hh^Fds, Mm, Mm, Mm, Mm, Mm, Hh^Vhh, Mm, Mm, Mm, Mm, Mm, Mm, Mm, Mm, Mm, Mm, Mm
Ww, Ww, Gs^Vh, Gs, Gs, Mm, Ce, Gs, Ce, Gs, Re, Gs, Gs^Fds, Gs^Fds, Mm, Mm, Mm, Mm, Mm, Hh^Fds, Mm, Mm, Ww, Mm, Mm, Mm, Mm, Mm, Mm, Gs, Mm, Mm, Mm, Mm, Mm, Mm, Mm
Gs, Gs, Gs^Fds, Gs^Fds, Gs, Mm, Ce, 2 Ke, Ce, Gs, Re, Gs, Gs^Vh, Gs^Fds, Mm, Mm, Mm, Mm, Mm, Mm, Mm, Mm, Ww, Mm, Mm, Mm, Mm, Mm, Mm, Mm, Mm, Mm, Mm, Mm, Mm, Mm, Mm
Gs^Fds, Gs^Fds, Gs, Gs^Fds, Gs, Mm, Mm, Hh, Hh, Gs, Hh, Re, Hh, Gs, Mm, Mm, Mm, Mm, Mm, Mm, Mm, Ww, Ww, Gs, Gs, Mm, Hh, Hh, Hh, Hh, Hh, Hh, Ww, Ww, Mm, Mm, Mm
Gs^Fds, Gs^Fds, Mm, Gs, Gs^Vh, Gs, Mm, Mm, Mm, Hh, Hh, Re, Hh, Mm, Mm, Mm, Mm, Mm, Hh, Hh, Hh, Ww, Hh, Gg^Vh, Gs, Hh, Hh^Fds, Hh, Hh, Gs, Gg^Vh, Gs^Fds, Ww, Mm, Mm, Mm, Mm
Mm, Mm, Mm, Mm, Mm, Mm, Mm, Mm, Mm, Mm, Hh, Re, Hh, Mm, Mm, Mm, Mm, Hh, Hh, Hh, Hh^Fds, Ww, Hh^Fds, Hh^Fds, Gs^Fds, Gs^Fds, Gs^Fds, Hh^Fds, Gs^Fds, Gs, Ww, Ww, Hh^Fds, Mm, Mm, Mm, Mm
Mm, Mm, Mm, Mm, Mm, Mm, Mm, Mm, Mm, Hh, Hh, Re, Hh, Hh, Hh, Mm, Hh, Hh, Hh, Hh, Gs^Fds, Ww, Ww, Gg, Ww, Gs^Fds, Gs^Fds, Re, Gs^Fds, Ww, Gs^Fds, Hh^Fds, Hh^Fds, Mm, Mm, Mm, Mm
Mm^Xm, Mm^Xm, Mm^Xm, Mm, Mm, Mm, Mm, Mm, Mm, Mm, Hh, Re, Re, Hh, Mm, Mm, Hh, Hh^Fds, Hh^Fds, Hh^Fds, Gs^Fds, Gs^Fds, Ww, Ww, Ww, Gg, Gg, Gs^Fds, Ww, Ww, Gs^Fds, Gs^Fds, Hh^Fds, Hh^Fds, Hh^Fds, Mm, Mm
Mm^Xm, Mm^Xm, Mm^Xm, Mm^Xm, Mm, Mm, Mm, Mm, Mm, Hh^Fds, Hh, Hh, Re, Hh, Hh, Hh, Hh, Hh, Gs^Fds, Gs^Fds, Gs^Fds, Gs^Fds, Gg^Vh, Ww, Ww, Ww, Ww, Ww, Ww, Gg, Gg, Gs^Fds, Gs, Gs^Fds, Mm, Mm, Mm
Mm^Xm, Mm^Xm, Mm^Xm, Mm, Mm, Mm, Mm, Mm, Mm, Hh, Hh^Fds, Hh, Re, Hh, Gs, Gs, Gs, Gs, Gs^Fds, Gs^Fds, Gs^Fds, Gs^Fds, Ww, Ww, Ww, Ww, Wo, Ww, Ww, Ww, Gs^Fds, Gs^Fds, Gs^Fds, Mm, Mm, Mm, Mm
Mm^Xm, Mm^Xm, Mm^Xm, Mm, Mm^Xm, Mm, Mm, Mm, Mm, Mm, Gs^Fds, Gs^Fds, Gs, Re, Re, Gg, Gg, Gg, Gg, Gg, Ww, Ww, Ww, Ww, Wo, Wo, Wo, Ww, Ww^Bw\, Gg, Gs^Fds, Gs^Fds, Gs^Fds, Gs^Fds, Gg, Mm, Mm
Mm^Xm, Mm^Xm, Mm, Mm, Mm, Mm, Mm, Mm, Mm, Gs^Fds, Hh, Gs^Fds, Gs, Gg, Re, Gg^Vh, Gg, Gg, Gg, Ww, Ww, Ww, Wo, Wo^_ml, Wo, Wo, Ww, Ww, Wwr, Gg^Vh, Gg, Gg, Gg, Gs^Fds, Gg^Vh, Mm, Mm
Mm^Xm, Mm^Xm, Mm, Mm, Mm, Mm, Mm, Mm, Mm, Mm, Mm, Hh, Hh^Fds, Gs, Gg, Re, Re, Gg, Gs^Fds, Ww, Ww, Wo, Wo, Wo, Wo, Wo, Wo, Wwr, Wo, Wo, Wo, Gg, Gg, Gg, Mm, Mm, Mm
Mm, Mm, Mm, Mm, Mm, Mm, Hh^Fds, Mm, Hh^Fds, Mm, Mm, Hh, Hh, Gs, Gg, Gg, Re, Gg, Gs^Fds, Ww, Ww, Wo, Ww, Ww, Ww, Wo, Wo, Wo, 1 Wo, Wo, Gs, Gg, Gs^Fds, Gg, Mm, Mm, Mm
Mm, Mm, Mm, Mm, Mm, Hh^Fds, Gs^Fds, Gs^Fds, Gs^Fds, Mm, Hh, Hh, Hh, Gs, Gs, Gg, Re, Gs^Fds, Ww, Ww, Ww, Ww, Ww, Ds^Esd, Ww^Wkf, Wo, Gs, Wo, Gs, Gs, Gs, Gs^Vh, Gd^Eff, Gs^Fds, Gs, Mm, Mm
Mm, Mm, Mm, Mm, Hh^Fds, Hh^Fds, Gs^Fds, Gg^Vh, Ww, Gs^Fds, Ww, Hh, Hh, Hh, Gs, Gg, Gg, Re, Ww, Ww, Ds^Esd, Ww^Wkf, Gs^Fdf, Ds, Gs, Gs, Gd^Es, Gd, Rr, Gs, Gll^Fdf, Gll^Fdf, Gll^Gvs, Gd^Eff, Gd^Vh, Mm, Mm
Mm, Mm, Mm, Mm, Hh^Fds, Hh^Fds, Gs^Fds, Ww, Ww, Ss, Ww, Gs, Gs, Gs, Gg, Gg, Gg, Re, Gg^Vh, Ww, Ds, Gs^Fdf, Gs^Fdf, Gs^Fdf, Ch, Ch, Ch, Rr, Gd^Eff, Gd^Eff, Gll^Gvs, Gll^Gvs, Gll^Gvs, Gll^Gvs, Gd, Md, Mm
Mm, Mm, Mm, Mm, Hh^Fds, Hh^Fds, Gll^Qhhf, Ss, Rb^Em, Ss, Ss, Gs^Fds, Gs, Hh, Gg, Gg, Gg, Re, Gg, Ww, Gs, Gs^Fdf, Gs^Vh, Gd, Ch, Kh, Ch, Re, Gs, Gd^Eff, Gs^Vh, Gll^Gvs, Gd, Gd^Wm, Hh, Hh, Mm
Mm, Mm, Mm, Hh, Hh, Gll^Vh, Hh, Rb^Em, Rb^Em, Ss, Ww, Ss, Re, Gs^Vh, Re, Gg, Re, Re, Ww, Ww, Gs, Gd, Gs, Gs, Rr, Ch, Re, Re, Gs, Hhd^Fdf, Hhd^Fdf, Gd, Hh, Hh, Md, Gd, Mm
Mm, Mm, Md, Hh, Hh, Hh, Hh, Rb^Em, Rb^Em, Rb^Em, Rb, Ww^Bw/, Ww, Re, Ss, Re, Ss, Re, Ww^Bw\, Gs, Rr, Gs, Rr, Rr, Gs, Re, Gs, Gll^Fdf, Gll^Fdf, Hhd^Fdf, Hhd^Fdf, Md, Md, Md, Mm, Mm, Mm
Md, Md, Md, Md, Md, Hh, Hh, Hh, Rb, Rb, Gd^Es, Gg^Vh, Ss, Ss, Ss, Ss, Ss, Ww, Gs, Rr, Gd^Vh, Rr, Gs, Gs, Gd^Es, Gs, Gll^Fdf, Gll^Fdf, Md, Hhd^Feth, Mm, Hh^Fds, Mm, Mm, Mm, Mm, Mm
Mm, Md, Md, Md, Hh, Hh, Hh, Re, Gll, Gll^Es, Md, Ww, Ww, Ww, Ss, Ss, Ss, Ss, Hh^Fds, Hhd, Hhd, Gs, Mm, Mm, Mm, Gd^Es, Mm, Md, Mm, Mm, Mm, Mm, Mm, Mm, Mm, Mm, Mm
Mm, Mm, Mm, Md, Ce, Hh, Rb, Re, Gd^Vh, Md, Md, Hh, Hh, Ww, Gs, Gs, Mm, Gs^Fds, Gs^Fds, Hh^Fds, Hh, Mm, Mm, Mm, Mm, Mm, Mm, Mm, Mm, Mm, Mm, Mm, Mm, Mm, Mm, Mm, Mm
Mm, Mm, Mm, Ce, Ce, Re, Hh, Re, Re, Re, Ch, Mm, Mm, Hh, Mm, Gs, Mm, Gs^Fds, Mm, Mm, Mm, Mm, Mm, Mm, Mm, Mm, Mm, Mm, Mm, Mm, Gs, Mm, Mm, Mm, Mm, Mm, Mm
Mm, Mm, Mm, Mm, Mm, Hh, Mm, Md, Ch, Re, Re, Hh, Mm, Mm, Mm, Mm, Mm, Mm, Mm, Mm, Mm, Mm, Mm, Mm, Mm, Mm, Mm, Mm, Mm, Mm, Mm, Gs^Vh, Mm, Mm, Mm, Mm, Mm
Mm, Mm, Mm, Mm, Mm, Mm, Mm, Mm, Hh, Re, Re, Hh, Mm, Mm, Mm, Mm, Mm, Mm, Mm, Mm, Mm, Mm, Mm, Mm, Mm, Mm, Mm, Mm, Mm, Mm, Mm, Mm, Mm, Mm, Mm, Mm, Mm
