Mm^Xm, Mm^Xm, Mm^Xm, Mm, Mm, Mm, Mm, Mm, Mm, Mm, Ha, Re, Re, Ha, Mm, Mm, Ha, Ha^Fda, Ha^Fda, Ha^Fda, Aa^Fda, Aa^Fda, Ai, Ai, Ai, Gll, Gll, Aa^Fda, Ai, Ai, Aa^Fda, Aa^Fda, Ha^Fda, Ha^Fda, Ha^Fda, Mm, Mm
Mm^Xm, Mm^Xm, Mm^Xm, Mm^Xm, Mm, Mm, Cea, Cea, Cea, Ha^Fda, Ha, Ha, Re, Ha, Ha, Ha, Ha, Ha, Aa^Fda, Aa^Fda, Aa^Fda, Aa^Fda, Aa^Vha, Ai, Ai, Ww, Ww, Ai, Ai, Gll, Gll, Aa^Fda, Cea, Aa^Fda, Mm, Mm, Mm
Mm^Xm, Mm^Xm, Mm^Xm, Mm, Mm, Mm, Cea, 4 Kea, Cea, Ha, Ha^Fda, Ha, Re, Ha, Gll, Aa, Gll, Gll, Gll^Fdw, Gll^Fdw, Gll^Fdw, Aa^Fda, Ww, Ai, Ww, Ww, Wo, Ww, Ww, Ww^Wkf, Gll^Qhhf, Cea, 3 Kea, Cea, Mm, Mm, Mm
Mm^Xm, Mm^Xm, Mm^Xm, Mm, Mm^Xm, Mm, Mm, Cea, Mm, Mm, Aa^Fda, Aa^Fda, Aa, Re, Re, Gll, Gd, Gd, Gs, Gd, Ww, Ww, Ww, Ww, Wo^_ml, Wo, Wo, Wwr, Ww, Ds^Esd, Gll^Qhhf, Cea, Cea, Cea, Aa, Mm, Mm
Mm^Xm, Mm^Xm, Mm, Mm, Mm, Mm, Mm, Mm, Mm, Aa^Fda, Hhd, Aa^Fda, Gll, Gll, Re, Gs^Vh, Gd, Gs, Gd, Ww, Ww, Ww, Wo, Wo, Wo, Wo, Ww, Ww, Wwr, Gd^Vh, Gd^Qhh, Gd, Gll, Gll^Qhhf, Gd^Vh, Md, Mm
Mm^Xm, Mm^Xm, Mm, Mm, Mm, Mm, Mm, Mm, Mm, Mm, Mm, Hhd, Hhd^Fdw, Gd, Gd, Re, Re, Gd, Gs^Fdw, Ww, Ww, Wo, Wo, Wo, Ww, Wo, Wo, Wwr, Wo, Wo, Wo, Gll^Qhh, Gd, Gll, Md, Md, Md
Mm, Mm, Mm, Mm, Mm, Mm, Hhd^Fdw, Mm, Hhd^Fdw, Mm, Mm, Hhd, Hhd, Gll, Gs, Gd, Re, Gd, Gs^Fdf, Ww, Ww, Wo, Ww, Ww, Ds^Esd, Ww, Wo, Wo, Wo, Wo, Gs^Qhh, Gll^Qhh, Gd^Fdw, Gd, Md, Md, Md
Mm, Mm, Mm, Mm, Mm, Hhd^Fdw, Gll^Fdf, Gd^Fdw, Gd^Fdf, Mm, Hhd, Hhd, Hhd, Gd, Gd, Gd, Re, Ch, Ww, Ww, Ww, Ww, Ww, Wwr, Ds, Ww^Wkf, Gs^Qhh, Gs^Qhh, Gs^Qhh, Gs^Qhh, Gd, Gs^Vh, Gd^Eff, Gd^Fdf, Gs, Md, Md
Md, Md, Md, Mm, Hhd^Fdw, Hhd^Fdf, Gd^Qhhf, Gd^Vh, Ww, Gll^Fdw, Ww, Hhd, Hhd, Hhd, Gd, Ch, Gd, Re, Ww, Ww, Ds^Esd, Ww^Wkf, Gs^Qhhf, Gs^Qhhf, Gd^Qhh, Gd^Qhh, Gd^Es, Gd, Rr, Gd, Gll^Fdf, Gll^Fdf, Gll^Gvs, Gd^Eff, Gd^Vh, Md, Md
Md, Md, Md, Md, Hhd^Fdf, Hhd^Fdf, Gll^Qhhf, Sm, Sm^Wkf, Ss, Sm^Wkf, Gll, Gd, Gd, Gd, Gd, Gd, Re, Gd^Vh, Ww, Ds, Gs^Qhhf, Gs^Qhhf, Gs^Fdf, Chr, Chr, Chr, Rr, Gd^Eff, Gd^Eff, Gll^Gvs, Gll^Gvs, Gll^Gvs, Gll^Gvs, Gd, Md, Md
Md, Md, Md, Md, Hhd^Fdf, Hhd^Fdf, Gll^Qhhf, Ss, Rb^Em, Ss^Wkf, Ss, Gll^Fdw, Gll, Hhd, Gd, Gd, Gd, Re, Gd, Ww, Gd^Qhh, Gs^Qhhf, Gs^Vh, Gd, Chr, 1 Khr, Chr, Re, Gd^Es, Gd^Eff, Gs^Vh, Gll^Gvs, Gd, Gd^Wm, Hhd, Hhd, Md
Md, Md, Md, Hhd, Hhd, Gll^Vh, Hhd, Rb^Em, Rb^Em, Ss, Sm^Wkf, Ss, Re, Gd^Vh, Re, Gd, Re, Re, Wwg^Wkf, Ww, Gd^Qhh, Gd, Gd, Gd^Es, Rr, Chr, Re, Re, Gd, Hhd^Fdf, Hhd^Fdf, Gd, Hhd, Hhd, Md, Gd, Md
Md, Md, Md, Hhd, Hhd, Hhd, Hhd, Rb^Em, Rb^Em, Rb^Em, Rb, Ww^Bw/, Sm^Wkf, Re, Ss, Re, Ss, Re, Ww^Bw\, Gd, Rr, Gd^Qhh, Rr, Rr, Gd, Re, Gd, Gll^Fdf, Gll^Fdf, Hhd^Fdf, Hhd^Fdf, Md, Md, Md, Md, Md, Md
Md, Md, Md, Md, Md, Hhd, Hhd, Hhd, Rb, Rb, Gd^Es, Gg^Vh, Ss, Ss, Ss^Wkf, Ss^Wkf, Ss, Sm^Wkf, Gd, Rr, Gd^Vh, Rr, Gd^Es, Gd, Gd^Es, Gd^Qhh, Gll^Fdf, Gll^Fdf, Md, Hhd^Feth, Md, Hhd^Fdf, Md, Md, Md, Md, Md^Xm
Md, Md, Md, Md, Ce, Hhd, Hhd, Re, Gll, Gll^Es, Md, Wwg^Wkf, Wwg, Sm, Ss, Ss, Ss, Ss, Hhd^Fdf, Hhd, Hhd, Gd^Qhh, Md, Md, Md, Gd^Es, Md, Md, Md, Md, Md^Xm, Md, Md, Md, Md^Xm, Md^Xm, Md^Xm
Md, Md, Md, Md, 2 Ke, Ce, Rb, Re, Gd^Vh, Md, Md, Hhd, Hhd, Ww^Wkf, Gll, Gs, Md, Gd^Fdf, Gs^Fdf, Hhd^Fdf, Hhd, Md, Md, Md^Qhh, Md, Md, Md, Md, Md^Xm, Md^Xm, Md^Xm, Md^Xm, Md^Xm, Md^Xm, Md^Xm, Md^Xm, Md^Xm
Md^Xm, Md, Md, Ce, Ce, Rb, Hhd^Es, Re, Re, Md, Ch, Md, Md, Hhd, Md, Gd, Md, Gs^Fdf, Md, Md, Md, Md^Qhh, Md^Qhh, Md^Qhh, Md^Qhh, Md^Xm, Md^Xm, Md^Xm, Md^Xm, Md^Xm, Gd, Md, Md, Md, Md^Xm, Md^Xm, Md^Xm
Md^Xm, Md, Md, Md, Md, Hhd, Md, Md, Ch, Re, Re, Hhd, Md, Md, Md, Md, Md, Md, Md, Md, Md, Md, Md^Xm, Md^Qhh, Md^Qhh, Md^Qhh, Md^Qhh, Md^Xm, Md^Xm, Md, Md, Gd^Vh, Md, Md, Md, Md^Xm, Md^Xm
Md^Xm, Md^Xm, Md, Md, Md, Md, Md, Md, Hhd, Re, Re, Hhd, Md, Md, Md, Md, Md^Xm, Md^Xm, Md^Xm, Md^Xm, Md^Xm, Md^Xm, Md^Xm, Md^Xm, Md^Xm, Md^Qhh, Md^Qhh, Md^Qhh, Md^Qhh, Md, Md, Md, Gs^Fdw, Md, Md, Md^Xm, Md^Xm
Md^Xm, Md^Xm, Md^Xm, Md, Md, Md, Md, Md, Gd^Fdf, Gd^Fdw, Gd^Fdw, Re, Re, Md, Md, Md, Md, Md^Xm, Md, Md^Xm, Md^Xm, Md^Xm, Md^Xm, Md^Xm, Md^Xm, Md^Xm, Md^Xm, Md^Qhh, Md^Qhh, Hhd, Hhd^Fdw, Gs^Fdf, Gs^Fdw, Gs^Fdf, Hhd^Fdw, Md^_mhh, Md^Xm
Md^Xm, Md^Xm, Md^Xm, Md^Xm, Md^Xm, Md, Md, Md, Gd^Fdf, Gd^Fdf, Gd^Fdw, Gd^Fdw, Re, Rb, Rb, Gd^Fdf, Gd^Fdf, Md, Md, Md, Md, Md^Qhh, Md^Qhh, Md^Xm, Md^Xm, Md^Xm, Md, Md, Hhd, Hhd, Gs^Fdf, Gs^Fdw, Gs^Fdf, Gs^Fdw, Hhd^Feth, Md, Md^Xm
Md^Xm, Md^Xm, Md^Xm, Md^Xm, Md^Xm, Md^Xm, Md^Xm, Md, Md, Gd^Fdf, Gd^Feth, Gd^Fdw, Md^Xm, Re, Re, Re, Re, Gd^Fdf, Md, Md, Md, Md, Md, Md^Qhh, Md^Qhh, Md^Qhh, Md^Qhh, Md, Hhd^Qhh, Hhd, Gs^Fdf, Gs^Fdf, Gs^Fdf, Gs^Fdf, Ww^Qhu, Md, Md^Xm
Md^Xm, Md^Xm, Md^Xm, Md^Xm, Md^Xm, Md^Xm, Md^Xm, Md, Md, Md, Md^Xm, Md^Xm, Md^Xm, Md^Xm, Md, Re, Re, Re, Re, Md, Md, Md, Md^Qhh, Md, Md, Md, Md^Qhh, Md, Hhd, Hhd^Qhh, Gs^Es, Gs^Fdf, Wwg^Qhu, Ww^Qhu, Ww^Qhu, Ww^Qhu, Ww^Qhu
Md^Xm, Md^Xm, Md^Xm, Md^Xm, Md^Xm, Md^Xm, Md^Xm, Md^Xm, Md^Xm, Md^Xm, Md^Xm, Md^Xm, Md, Hhd, Hhd^Es, Md, Md, Re, Re, Re, Re, Md, Md, Md^Qhh, Md^Qhh, Md^Qhh, Md^Qhh, Hhd^Qhh, Hhd^Qhh, Hhd^Vhhr, Wwg^Qhu, Wwg^Qhu, Wwg^Qhu, Wwg^Qhu, Md, Ww^Qhu, Ww^Qhu
Md^Xm, Md^Xm, Md^Xm, Md^Xm, Md^Xm, Md^Xm, Md^Xm, Md^Xm, Md^Xm, Md^Xm, Md^Xm, Md^Xm, Hhd, Uu^Vud, Wwr^Qhu, Hhd, Hhd, Md, Wwr^Qhu, Re, Re, Re, Re, Md, Md, Md, Rb, Md^Qhh, Wwg^Qhu, Wwr^Qhu, Wwg^Qhu, Wwg^Qhu, Hhd^Es, Wwg^Qhu, Md, Md, Md^Xm
Md^Xm, Md^Xm, Md^Xm, Md^Xm, Md^Xm, Md^Xm, Md^Xm, Md^Xm, Md^Xm, Md^Xm, Md^Xm, Md^Xm, Md, Md, Ww^Qhu, Ww^Qhu, Ww^Qhu, Ww^Qhu, Hh^Qhhf, Ww^Qhu, Ww^Qhu, Re, Re, Re, Re, Gd^Vhr, Re, Re, Wwg^Qhu, Wwg^Qhu, Gs^Es, Gd^Vhr, Hhd, Wwg^Qhu, Wwg^Qhu, Md, Md^Xm
Md^Xm, Md^Xm, Md^Xm, Md^Xm, Md^Xm, Md^Xm, Md^Xm, Md^Xm, Md^Xm, Md^Xm, Md^Xm, Md^Xm, Md, Md, Md, Md, Md, Md, Md, Hh^Qhhf, Hh^Qhhf, Wwg^Qhu, Wwg^Qhu, Re, Sm^Qhu, Sm^_ml, Sm^Qhu, Sm^Qhu, Sm^Qhu, Ss^Qhu, Ss^Qhu, Hhd, Hhd^Qhh, Md^Qhh, Md, Wwg^Qhu, Wwg^Qhu
Md^Xm, Md^Xm, Md^Xm, Md^Xm, Md^Xm, Md^Xm, Md^Xm, Md^Xm, Md^Xm, Md^Xm, Md^Xm, Md^Xm, Md^Xm, Md, Md, Md, Md, Md, Md, Mm, Mm, Hh^Qhhf, Hh^Qhhf, Wwg^Qhu, Wwg^Qhu, Wwg^Bw|r, Wwg^Qhu, Sm^Qhu, Ss^Qhu, Ss^Qhu, Hh^Qhhf, Hh^Qhhf, Md, Md, Md, Md^Xm, Md
Md^Xm, Md^Xm, Md^Xm, Md^Xm, Md^Xm, Md^Xm, Md^Xm, Md^Xm, Md^Xm, Md^Xm, Md^Xm, Md^Xm, Md^Xm, Md^Xm, Md^Xm, Md, Md, Md, Md, Md, Md, Mm, Gll^Fdf, Hh^Qhhf, Gd, Rb, Rb, Ss^Qhu, Wwg^Qhu, Hh^Qhhf, Md, Hh^Qhhf, Md^Xm, Md^Xm, Md^Xm, Md^Xm, Md^Xm
Md^Xm, Md^Xm, Md^Xm, Md^Xm, Md^Xm, Md^Xm, Md, Md^Xm, Md, Md^Xm, Md, Md^Xm, Md^Xm, Md^Xm, Md, Md, Md, Md, Md, Md, Mm, Gll^Fdf, Gll^Fdf, Gll^Fdf, Rb, Rb, Mm, Mm, Wwg^Qhu, Md, Md, Md, Md^Xm, Md^Xm, Md^Xm, Md^Xm, Md^Xm
Md, Md^Xm, Md, Md, Md, Md, Md, Md, Md, Md, Md, Md, Md, Md, Md, Md, Mm, Md, Md, Gd^Feth, Md, Gll^Fdf, Gd, Rb, Gll^Fmf, Gll^Fmf, Gll^Fmf, Md, Wwg^Qhu, Wwg^Qhu, Md^Xm, Md^Xm, Md^Xm, Md^Xm, Md^Xm, Md^Xm, Md^Xm
Md^Xm, Md^Xm, Md, Md, Md, Md, Ce, Md, Md, Md, Md, Md, Md, Md, Mm, Mm, Mm, Md^Qhu, Gll^Fdf, Gll^Fdf, Gll^Fdf, Gll^Fdf, Gd, Rb, Gll^Fmf, Gll^Fmf, Md, Md, Md, Wwg^Qhu, Wwg^Qhu, Md^Xm, Md^Xm, Md^Xm, Md^Xm, Md^Xm, Md^Xm
Md^Xm, Md^Xm, Md, Md, Md, Ce, 5 Ke, Ce, Hhd, Hhd, Hhd, Hhd, Hhd, Mm, Mm, Mm, Md, Gll^Fmf, Gll^Fmf, Gll^Fdf, Gd, Gd, Rb, Rb, Gll^Fmf, Gll^Fmf, Md, Md, Md, Wwg^Qhu, Wwg^Qhu, Md^Xm, Md^Xm, Md^Xm, Md^Xm, Md^Xm, Md^Xm
Md^Xm, Md^Xm, Md, Md, Md, Ce, Ce, Ce, Md, Hhd, Md, Hhd, Hhd, Hhd, Hhd^Vhhr, Mm, Hhd, Gll^Fmf, Hhd, Gd, Rb, Re, Gll^Fmf, Gll^Fmf, Gll^Fmf, Gll^Fmf, Md, Md, Md, Wwg^Qhu, Wwg^Qhu, Md^Xm, Md^Xm, Md^Xm, Md^Xm, Md^Xm, Md^Xm
Md^Xm, Md^Xm, Md^Xm, Md, Md, Md, Md, Md, Md, Md, Mm, Mm, Mm, Hhd, Hhd, Hhd, Gd, Hhd, Rb, Rb, Md, Mm, Mm, Gll^Fmf, Md^Xm, Md, Md^Xm, Md, Md, Wwg^Qhu, Wwg^Qhu, Md, Md, Md^Xm, Md^Xm, Md^Xm, Md^Xm
Md^Xm, Md^Xm, Md^Xm, Md^Xm, Md^Xm, Md, Md, Md, Mm, Mm, Mm, Mm, Gll^Fdf, Mm, Gd, Gd, Rb, Rb, Hhd, Hhd^Vhhr, Hhd, Mm, Hhd, Mm, Ce, Md^Xm, Md^Xm, Md, Md, Wwg^Qhu, Wwg^Qhu, Md, Md, Md, Md, Md^Xm, Md^Xm
Md^Xm, Md^Xm, Md^Xm, Md^Xm, Md^Xm, Md, Md, Mm, Mm, Mm, Gll^Fdf, Gll^Fdf, Gd, Gd, Rb, Rb, Md^Qhu, Md^Qhu, Md, Hhd, Hhd, Hhd, Hhd, Ce, Ke, Ce, Md, Md, Md, Wwg^Qhu, Wwg^Qhu, Gll^Fmf, Gg^Fet, Md, Md^Xm, Md^Xm, Md^Xm
Md^Xm, Md^Xm, Md^Xm, Md^Xm, Md^Xm, Md, Mm, Mm, Mm, Gll^Fdf, Gll^Fdf, Gll^Fdf, Rb, Rb, Gll^Fdf, Gll^Fdf, Gll^Fdf, Gll^Fdf, Md, Md, Mm, Hhd, Mm, Ce, Ce, Ce, Hhd, Md, Md, Wwg^Qhu, Ww^Qhu, Gd^Vhr, Hh, Md, Md^Xm, Md^Xm, Md^Xm
Md^Xm, Md^Xm, Md^Xm, Md^Xm, Md, Md, Md, Mm, Mm, Hhd, Hhd, Gd, Rb, Gd, Gll^Fdf, Gll^Fdf, Md, Md, Md, Md, Mm, Mm, Mm, Mm, Mm, Mm, Md, Hhd, Gs^Efm, Wwg^Qhu, Wwg^Qhu, Ww^Qhu, Gll^Fdw, Md, Md^Xm, Md^Xm, Md^Xm
Md^Xm, Md^Xm, Md^Xm, Md^Xm, Md, Md, Md, Md, Hh^Qhhf, Mm, Hhd, Gd, Rb, Gll^Fdf, Gll^Fdf, Gll^Fdf, Md, Md, Md, Md^Xm, Md^Xm, Md^Xm, Md^Xm, Mm, Mm, Mm, Md, Md, Gd^Vhr, Wwg^Qhu, Ww^Qhu, Gll^Fdw, Gll^Fdw, Md, Md^Xm, Md^Xm, Md^Xm
Md^Xm, Md^Xm, Md^Xm, Md^Xm, Md^Xm, Md, Md, Md, Mm, Hh^Qhhf, Hhd, Hhd, Rb, Gd, Gd, Hhd, Md, Md, Md, Md^Xm, Md^Xm, Md^Xm, Md^Xm, Mm, Mm, Mm, Md, Hh, Ww^Qhu, Wwg^Qhu, Gll^Fdw, Gll^Fdw, Md, Md, Md^Xm, Md^Xm, Md^Xm
Md^Xm, Md^Xm, Md^Xm, Md^Xm, Md^Xm, Md, Md, Md, Md, Hh^Qhhf, Hhd, Hhd, Rb, Gll^Fdf, Gll^Fdf, Md^Qhu, Md, Md, Md, Md^Xm, Md, Md^Xm, Md, Md^Xm, Md^Xm, Mm, Md^Xm, Hh, Wwg^Qhu, Ww^Qhu, Gll^Fmf, Gll^Fdw, Md, Md, Md, Md^Xm, Md^Xm
Md^Xm, Md^Xm, Md^Xm, Md^Xm, Md^Xm, Md, Md, Md, Md, Md, Gll^Fdw, Hhd, Rb, Gll^Fdf, Gll^Fdf, Md^Qhu, Md, Md, Md, Md^Xm, Md, Md^Xm, Md, Md^Xm, Md^Xm, Md^Xm, Md^Xm, Hh, Wwg^Qhu, Ww^Qhu, Gll^Fmf, Gll^Fmf, Md, Md, Md, Md^Xm, Md^Xm
Md^Xm, Md^Xm, Md^Xm, Md^Xm, Md^Xm, Md, Md, Md, Md, Md, Gll^Fdw, Hhd^Vhhr, Rb, Gll^Fdf, Gll^Fdf, Md^Qhu, Md, Md, Md, Md^Xm, Md, Md^Xm, Md, Md^Xm, Md^Xm, Md^Xm, Md^Xm, Hh, Wwg^Qhu, Ww^Qhu, Gll^Fdw, Gll^Fdw, Md, Md, Md, Md^Xm, Md^Xm
Md^Xm, Md^Xm, Md^Xm, Md^Xm, Md^Xm, Md, Md, Md, Mm, Mm, Gll^Fdw, Gll^Fdw, Rb, Gll^Fdf, Gll^Fdf, Md^Qhu, Md, Md, Md, Md^Xm, Md, Md^Xm, Md, Md^Xm, Md^Xm, Md^Xm, Md^Xm, Hh, Wwg^Qhu, Gll^Fmf, Gll^Fmf, Gll^Fmf, Md, Md, Md, Md^Xm, Md^Xm
Md^Xm, Md^Xm, Md^Xm, Md^Xm, Md^Xm, Md, Md, Md, Mm, Mm, Gll^Fdw, Gll^Fdw, Rb, Gll^Fdf, Gll^Fdf, Md^Qhu, Md, Md, Md, Md^Xm, Md, Md^Xm, Md, Md^Xm, Md^Xm, Md^Xm, Md^Xm, Hh, Hh, Ww^Qhu, Gll^Fmf, Gll^Fdw, Md, Md, Md, Md^Xm, Md^Xm
Md^Xm, Md^Xm, Md^Xm, Md^Xm, Md^Xm, Md, Md, Md, Md, Mm, Hhd, Gll^Fdw, Rb, Gll^Fdf, Gll^Fdf, Md^Qhu, Hh^Fmf, Md, Hh^Fdf, Md^Xm, Md, Md^Xm, Md, Md^Xm, Md^Xm, Md^Xm, Md^Xm, Hh, Hh, Ww^Qhu, Ww^Qhu, Gll^Fmf, Md, Md, Md, Md^Xm, Md^Xm
