Ss, Ss, Gs, Re, Gs, Gs^Fdw, Ss, Ss, Gs^Fdw, Ww, Ww, Ww, Gs^Fdw, Gs^Fdw, Ss, Gs^Fdw, Gs, Hhd, Hhd, Hhd, Hhd, Hhd, Hhd, Hhd, Hhd, Hhd, Gs^Fdw, Gs^Fdw, Ww, Ww, Ww, Gs^Fdw, Gs^Fdw, Gs^Fdw, Ss, Gs^Fdw, Gs^Fdw
Ss, Ss, Gd^Vh, Re, Gs, Gs^Fdw, Ss, Ss, Gs^Fdw, Ww, Ww, Ww, Gs^Fdw, Gs^Fdw, Ss, Gs^Fdw, Gs^Vh, Hhd, Hhd^Fdw, Hhd^Fdw, Hhd^Fdw, Hhd, Hhd, Hhd, Hhd, Hhd, Gs^Fdw, Gs^Fdw, Ww, Ww, Ww, Gs^Fdw, Gs^Fdw, Gs^Fdw, Ss, Gs^Fdw, Gs^Fdw
Ss, Ss, Gd^Fdw, Re, Re, Ss, Ss, Gs^Fdw, Gs^Fdw, Ww, Wo, Ww, Gs^Fdw, Ss, Ss, Ss, Gs, Hhd, Gs^Fdw, Gs^Fdw, Gs^Fdw, Hhd, Hhd, Hhd, Cer, Re, Re, Gs^Vh, Ww, Ww, Ww, Ss, Ss, Ss, Ss, Ss, Ss
Ss, Ss, Gs^Fdw, Gd^Fdw, Re, Gd, Gd^Fdw, Gs^Fdw, Gs^Fdw, Ww, Wo, Ww, Ss, Ss, Ss^Vhs, Ss, Gs, Gs, Re, Gs^Vh, Re, Re, Re, Cer, 2 Ker, Cer, Re, Ss, Ww, Ww, Ww, Ss, Ss, Ss, Ss, Gd, Gd
Ss, Ss, Ss, Gs, Re, Gd, Ss, Gs^Vht, Ss, Ww, Ww, Ww, Ss, Ss, Gs^Fdw, Ss, Re, Re, Re, Re, Gs^Fdw, Hhd^Fdw, Hhd, Cer, Cer, Cer, Ss, Ss, Ww, Ww, Gs, Gs, Gs, Ss, Ss, Gd, Gd
Ss, Ss, Ss^Vhs, Ss, Ss, Re, Ss, Ss, Ss, Ss, Ww, Ww, Wwf, Ss, Rr, Re, Ss, Ss, Ss, Re, Gs^Fdw, Gs^Fdw, Hhd^Fdw, Hhd, Gs^Fdw, Re, Ss, Ww, Ww, Ss, Gs^Fdw, Gs^Fdw, Gd, Ss, Gd, Gd, Gd
Ss, Ss, Ss, Ss, Ss, Re, Re, Ss, Ss, Ss, Wwf, Wwf, Wwf, Wwf, Wwf, Gs^Fdw, Ss, Gs^Ft, Ss, Ss, Gs^Fdw, Hhd^Fdw, Hhd, Gs^Fdw, Ss, Ss, Ss, Ww, Ww, Gs^Fdw, Hhd^Fdw, Gs^Fdw, Gd, Gs^Vht, Gs^Fdw, Gs^Fdw, Gs^Fdw
Ss, Ss, Ss, Ss, Gs, Ss, Ss, Rr, Ss, Ss, Rr, Wwf, Wwf, Ww, Ww, Gs^Fdw, Gs^Fdw, Ss, Ss, Ss, Gs^Fdw, Gs^Fdw, Gs^Fdw, Gs^Vh, Ss, Ss, Ss, Ww, Ww, Gs^Fdw, Hhd^Fdw, Hhd^Fdw, Gd, Gd, Gd, Gs^Fdw, Gs^Fdw
Gs^Fdw, Gs^Fdw, Chr, Chr, Chr, Gs, Rr, Rr, Rr, Rr, Gs^Fdw, Gs^Fdw, Ss, Ss, Ww, Ww, Ww, Gs, Gs^Fdw, Gs, Gs^Fdw, Gs^Fdw, Gs^Fdw, Gs, Gs, Ss, Ww, Ww, Ww, Gs^Fdw, Gs, Gs^Fdw, Ss, Ss, Ss, Gs, Gg
Gs^Fdw, Gs^Fdw, Chr, 1 Khr, Chr, Rr, Ss, Rr, Gs^Fdw, Ss, Gs^Fdw, Ss, Ss, Ss, Ww, Wo, Wo, Ww, Ww, Gs^Fdw, Ss, Ss, Gs^Fdw, Gs^Fdw, Gs, Ww, Ww, Ww, Gs, Gs, Ss, Ss, Ss, Ss, Ss, Gs, Gg
Gs^Fdw, Gs^Fdw, Gs, Chr, Gs^Fp, Gs^Fp, Ss, Re, Gs^Vh, Gs, Gs, Ss, Gs^Fdw, Ww, Ww, Wo, Wo, Wo, Ww, Gs^Fdw, Ss, Ss, Gs^Fdw, Gs, Ww, Ww, Ww, Ss, Ss, Ss, Ss, Ss, Ss, Ss, Gs^Fdw, Hhd^Fdw, Hhd^Fdw
Ss, Ss, Ss, Ss, Ss, Ss, Ss, Re, Ss, Ss, Ss, Ss, Ss, Gs^Fdw, Gs^Fdw, Ww, Ww, Wo, Ww, Ss, Ss, Ss, Gs, Gs, Ww, Ww, Ww, Ss, Gs^Fdw, Ss, Ss, Ss, Ss, Gs^Fdw, Gs^Fdw, Hhd^Fdw, Hhd^Fdw
Ss, Ss, Ss, Ss, Ss, Ss, Gs^Fdw, Re, Gs^Fdw, Ss, Ss, Ss, Ss, Gs, Gs^Fdw, Gs^Fdw, Gs^Fdw, Ww, Ww, Ww, Gs, Ss, Gs^Vh, Ww, Wo, Wo, Ww, Gs^Fdw, Gs^Fdw, Gs^Fdw, Gs, Gs, Gs, Gs^Fdw, Re, Gs, Gg
Ss, Ss, Ss, Ss, Ss, Ss, Gs^Fdw, Re, Gs^Fdw, Gs, Ss, Ss, Gs^Fdw, Gs^Fdw, Gs^Fdw, Gs^Fdw, Gs^Fdw, Ss, Ww, Ss, Gs^Fdw, Gs, Gs, Ww, Wo, Wo, Ww, Ww, Gs^Fdw, Gs^Fdw, Ss, Gs, Re, Gs, Gs, Gs^Fdw, Gs^Fdw
Ss, Ss, Gs^Fdw, Gs^Fdw, Gs^Fdw, Gs^Fdw, Re, Re, Gs^Fdw, Gs, Ss, Ss, Ss, Ss, Ss, Ss, Ss, Ss, Ww, Ss, Gs^Fdw, Hhd^Fdw, Gs, Ww, Ww, Wo, Ww, Ss, Ss, Ss, Ss, Ss, Re, Gs^Fdw, Hhd^Fdw, Hhd^Fdw, Hhd^Fdw
Ss, Ss, Ss, Gs^Fdw, Re, Re, Gs^Vh, Gs^Fdw, Gs^Fdw, Gs, Gs, Ss, Ss, Ss, Ss, Ss, Gs^Fdw, Ss, Ww, Ww, Gs^Fdw, Hhd, Hhd^Fdw, Gs, Ww, Ww, Ww, Ss, Gs, Gs, Gs, Gs, Gs^Fdw, Gs^Fdw, Hhd^Fdw, Hhd^Fdw, Hhd
Ss, Ss, Ss, Gs^Fdw, Re, Gs, Gs, Gs^Fdw, Ss, Ss, Ss, Ss, Ss, Gs^Fdw, Ss, Gs^Fdw, Gs^Fdw, Ww, Wo, Ww, Ww, Gs^Fdw, Gs^Fdw, Gs^Fdw, Ww, Ww, Ss, Ss, Gd, Gs, Ss, Re, Gs^Fdw, Gs^Fdw, Gs^Fdw, Hhd, Hhd
Ss, Ss, Ss, Gs^Fdw, Gs^Fdw, Re, Re, Gs, Gs, Ss, Ss, Ss, Gs^Fdw, Ss, Gs^Fdw, Gs^Fdw, Gs^Fdw, Ww, Ww, Wo, Wo, Ww, Gs^Fdw, Gs^Fdw, Ww, Ww, Ww, Ss, Ss, Ss, Ss, Re, Gs^Ft, Gs^Fdw, Hhd^Fdw, Hhd, Hhd
Ss, Ss, Ss^Vhs, Ss, Gs^Fdw, Gs, Re, Gs, Gs^Fdw, Gs, Ss, Gs, Ss, Gs^Fdw, Ss, Gs^Fdw, Gs^Fdw, Gs, Gs, Ww, Wo, Ww, Ww, Ww, Wo, Ww, Ww, Gd, Gs^Vht, Ss, Ss, Re, Gs^Fdw, Gs, Hhd, Hhd, Hhd
Ss, Ss, Ss, Ss, Re, Re, Gs^Fdw, Gs^Fdw, Gs^Fdw, Gs, Ss, Ss, Ss, Ss, Gs, Gs^Fdw, Gs^Fdw, Gs^Fdw, Gs, Ww, Ww, Wo, Wo, Wo, Ww, Ww, Gs^Fdw, Gs^Fdw, Gs^Ft, Ss, Re, Gs, Gs^Fdw, Gs, Hhd, Hhd, Hhd
Ss, Ss, Gs^Vh, Gs, Re, Gs^Fdw, Gs^Fdw, Gs, Ss, Gs, Ss, Ss, Ss, Ss, Ss, Gs^Fdw, Gs^Fdw, Gs^Fdw, Gs^Fdw, Gs^Fdw, Ww, Wo, Wo, Ww, Ww, Gs^Fdw, Gs^Fdw, Ss, Gs^Fdw, Gs^Fdw, Re, Gs^Fdw, Gs^Fdw, Hhd^Fdw, Gs^Fdw, Hhd, Hhd
Ss, Ss, Gs, Re, Gs, Gs^Fdw, Gs^Fdw, Gs^Fdw, Ss, Ss, Ss, Ss, Ss, Ss, Ss, Ss, Gs^Fdw, Hhd^Fdw, Hhd^Fdw, Gs^Fdw, Ww, Ww, Wo, Ww, Ww, Gs, Gs, Gs^Fdw, Gs, Gs, Re, Gs^Ft, Ss, Gs^Vh, Gs, Hhd, Hhd
Ss, Ss, Ss, Re, Gs, Gs^Fdw, Gs^Fdw, Gs^Fdw, Gd, Ss, Ss, Ss^Vhs, Ss, Ss, Ss, Ss, Gs^Fdw, Hhd^Fdw, Gs^Fdw, Gs^Fdw, Ww, Ww, Wo, Wo, Ww, Ww, Gs^Vh, Gs, Gs, Ss, Chs, Ss, Ss, Gs, Gs, Gs, Gg
Ss, Ss, Gs, Rd, Rd, Gs, Rd, Gs^Fdw, Gd, Ss, Ss, Ss, Gs^Fdw, Gs^Fdw, Gs^Fdw, Ss, Gs^Fdw, Gs, Gs, Gs, Ww, Ww, Wo, Wo, Ww, Ww, Ss, Gs, Ss, Chs, 3 Khs, Chs, Ss, Ss, Gs, Gs, Gg
Ss, Ss, Ss, Gs, Rd, Gs^Vh, Rd, Rd, Rd, Ss, Ss, Ss, Gd, Gs^Fdw, Gs^Fdw, Gs^Fdw, Ss, Gs, Ss, Ss, Ss, Ww, Wo, Ww, Ww, Ww, Ss, Gd, Ss, Chs, Chs, Chs, Ss, Ss, Gs, Gs^Fdw, Gs^Fdw
Ss, Ss, Ss, Gs, Gd, Rd, Gd, Gd, Gd, Rd, Rd, Rd, Rd, Gd, Gd, Gs^Fdw, Ss, Ss, Ss, Ss, Ss, Ww, Wo, Wo, Ww, Ww, Ww, Ss, Ss, Ss, Ss, Ss, Gd, Ss, Gs^Ft, Gs^Fdw, Gs^Fdw
Ss, Ss, Ss, Gs, Gs, Gd, Gd, Ss, Gd, Gd, Ss, Gd, Gd, Rd, Rd, Gd, Gd, Ss, Ss^Vhs, Gd, Ss, Ww, Wo, Wo, Wo, Ww, Ww, Ss, Ss, Ss, Re, Ss, Ss, Gd, Gs^Ft, Gs^Ft, Gs^Ft
Ss, Ss, Ss, Ss, Ss, Gd, Gd, Gd, Ss, Ss, Ss, Ss, Gd, Gd, Rd, Gd, Gd, Ss, Ss, Ss, Gs^Fdw, Ww, Ww, Wo, Wo, Ww, Ww, Ww, Ss, Gs^Ft, Re, Ss, Ss, Ss, Gd, Gs^Fdw, Gs^Fdw
Ss, Ss, Gd, Ss, Ss, Ss, Gd, Ss, Ss, Ss, Ss, Ss, Ss, Gs^Fdw, Rd, Gd, Gs^Fdw, Ss, Ss, Gs^Fdw, Ss, Gs^Fdw, Gs^Fdw, Ww, Ww, Wo, Wo, Ww, Gs^Fdw, Gs^Ft, Gs^Ft, Ss, Ss, Ss, Ss, Gd, Gd
Gd, Gd, Gs^Fdw, Gd, Gs^Fdw, Gd, Gs^Fdw, Ss, Ss, Ss, Ss, Ss, Ss, Gs^Fdw, Rd, Gd, Gd, Gs^Fdw, Rd, Gs^Fdw, Gs^Fdw, Gs^Fdw, Gs^Fdw, Ww, Wo, Wo, Wo, Ww, Gs, Gd, Gs^Ft, Ss, Gs^Ft, Ss, Gs^Ft, Gs^Fdw, Gs^Fdw
Gs^Fdw, Gs^Fdw, Gs^Fdw, Gs^Fdw, Gs^Fdw, Gs^Fdw, Gs^Fdw, Gd, Gs^Fdw, Gd, Gd, Ss, Ss, Gd, Gd, Rd, Rd, Rd, Gs^Fdw, Rd, Rd, Rr, Rr, Ww, Ww, Wo, Wo, Ww, Gs^Vh, Ss, Re, Re, Gs^Ft, Gd, Gd, Gs^Ft, Gs^Ft
Gs^Fdw, Gs^Fdw, Hhd^Fdw, Gs^Fdw, Gs^Fdw, Gs^Fdw, Re, Gs^Fdw, Gs^Fdw, Gs^Fdw, Gd, Ss, Gd, Gd, Rd, Gd, Ss, Gd, Gs^Fdw, Gs^Fdw, Gs^Fdw, Gs^Fdw, Rr, Wwf, Wwf, Ww, Ww, Ww, Gs, Gd, Re, Gs^Fdw, Ss, Ss, Ss, Gs^Fdw, Gs^Fdw
Hhd^Fdw, Hhd^Fdw, Gs^Fdw, Gs^Fdw, Gs^Fdw, Gs^Fdw, Gs^Fdw, Gs^Fdw, Gd, Gd, Ss, Gd, Gd, Gd, Gd, Gd, Ss, Ss, Gd, Gd, Ss, Gs^Vht, Gd, Wwf, Ww, Wwf, Wwf, Wwf, Wwf, Gd, Re, Ss, Ss^Vhs, Ss, Ss, Gs^Ft, Gs^Ft
Hhd^Fdw, Hhd^Fdw, Hhd, Re, Hhd, Gd, Gd, Gd, Ss, Ss, Ss, Gd, Gd, Gs^Fdw, Gs^Fdw, Gd, Gd, Ss, Ss, Ss, Ss, Ss, Ss, Ss, Ww, Ww, Ww, Wwf, Wwf, Gs^Vh, Re, Gs^Ft, Ss, Gs^Ft, Gs^Fdw, Gs^Fdw, Gs^Fdw
Hhd, Hhd^Fdw, Hhd^Fdw, Hhd, Gd, Gd, Gd, Gd, Gd, Ss, Gd, Gd, Gd, Gs^Fdw, Gs^Fdw, Gs^Vht, Gd, Ss, Ss, Ss, Ss, Ss, Gs^Ft, Gd, Ww, Wo, Wo, Ww, Wwf, Rr, Gs^Fdw, Re, Re, Gs^Fdw, Re, Gs^Fdw, Gs^Fdw
Hhd, Hhd^Fdw, Hhd, Re, Gd, Gd, Gs^Fdw, Gs^Vht, Gd, Gd, Gd, Gd, Re, Gd, Re, Gd, Gd, Ss, Ss, Ss^Vhs, Ss, Ss, Ss, Gs^Fdw, Ww, Wo, Wo, Ww, Ww, Gs^Fdw, Gs^Fdw, Gs^Fdw, Gs^Fdw, Re, Gs, Re, Re
Hhd^Fdw, Hhd^Fdw, Hhd^Fdw, Re, Gs^Fdw, Gs^Fdw, Gs^Fdw, Gs^Fdw, Gd, Gd, Gd, Gd, Gs^Fdw, Re, Cer, Re, Re, Gd, Gd, Ss, Gd, Ss, Ss, Ss, Ww, Wo, Wo, Wo, Ww, Ww, Gs^Fdw, Gs^Ft, Ss, Ss, Gs, Gs^Fdw, Gs^Fdw
Hhd^Fdw, Hhd^Fdw, Gs^Fdw, Gs^Fdw, Gs^Fdw, Gs^Fdw, Gs^Fdw, Gd, Re, Re, Ss, Gs^Fdw, Gs^Fdw, Cer, 4 Ker, Cer, Re, Ss, Gd, Gd, Ss, Ss, Re, Gs^Fdw, Gs^Fdw, Ww, Ww, Wo, Wo, Ww, Ss, Ss, Ss, Ss, Ss, Gs, Gg
Hhd^Fdw, Hhd^Fdw, Gs^Fdw, Gs^Fdw, Gs^Fdw, Gs^Fdw, Gd, Gd, Gd, Gd, Gs^Fdw, Gs^Fdw, Gs^Fdw, Cer, Cer, Cer, Re, Gd, Gd, Gd, Ss, Ss, Gd, Gs^Fdw, Ss, Ss, Ss, Ww, Wo, Ww, Ww, Gs, Gs^Vh, Ss, Ss, Ss, Ss
Gs^Fdw, Gs^Fdw, Gs^Fdw, Gs^Fdw, Gs^Fdw, Gd, Gd, Gd, Gs^Fdw, Gs^Vht, Gs^Fdw, Gs^Fdw, Gs^Fdw, Gs^Fdw, Gs^Fdw, Gs^Fdw, Gs^Fdw, Gs^Fdw, Gs^Vht, Gs^Fdw, Gs^Fdw, Ss, Ss, Ss, Ss, Ss, Gs^Fdw, Ww, Wo, Wo, Ww, Ww, Ss, Ss, Ss, Ss, Ss
Gs^Fdw, Gs^Fdw, Gs^Fdw, Gs^Fdw, Gd, Gd, Gd, Gs^Fdw, Gs^Fdw, Gs^Fdw, Gs^Fdw, Gs^Fdw, Gs^Fdw, Gs^Fdw, Gs^Fdw, Gs^Fdw, Gs^Fdw, Gs^Fdw, Gs^Fdw, Gs^Fdw, Gs^Fdw, Gs^Fdw, Gs^Fdw, Ss, Gs^Fdw, Gs^Fdw, Gs^Fdw, Ww, Ww, Wo, Wo, Ww, Ww, Gs, Gs^Fdw, Gs^Fdw, Gs^Fdw
Gs^Fdw, Gs^Fdw, Gs^Fdw, Gs^Fdw, Gd, Gd, Gd, Gs^Fdw, Gs^Fdw, Gs^Fdw, Gs^Fdw, Gs^Fdw, Gs^Fdw, Gs^Fdw, Gs^Fdw, Gs^Fdw, Gs^Fdw, Gs^Fdw, Gs^Fdw, Gs^Fdw, Gs^Fdw, Gs^Fdw, Gs^Fdw, Ss, Gs^Fdw, Gs^Fdw, Gs^Fdw, Ww, Ww, Wo, Wo, Ww, Ww, Gs, Gs^Fdw, Gs^Fdw, Gs^Fdw
