Hhd, Hhd, Hhd, Hhd, Hhd, Hhd, Hhd, Hhd, Hhd, Rb, Rb, Rb, Rb, Hhd, Hhd, Hhd, Hhd^Fdf, Hhd^Fdf, Hhd^Fdf, Re, Re, Hhd, Hhd, Hhd^Fdf, Hhd^Fdf, Gs^Fdf, Gs^Fdf, Gs^Fdf, Gs, Gd, Gd, Re, Gs, Gd, Re, Gs, Gd, Gd, Gs, Gs, Gs^Fmf, Gs^Fmf
Hhd, Hhd, Hhd^Fdf, Hhd^Fdf, Hhd, Hhd, Hhd, Hhd, Hhd, Rb^Dr, Re^Edt, Rb^Edt, Re^Edt, Hhd, Hhd, Hhd, Hhd^Fdf, Hhd^Fdf, Gs^Fdf, Re, Re, Hhd, Hhd, Hhd^Fdf, Hhd^Fdf, Hhd^Fdf, Gs^Fdf, Gs^Fdf, Gs, Gd, Gd, Re, Chr, Gd, Re, Gs, Re, Gd, Gs, Gs, Gs^Fmf, Gs^Fmf
Hhd, Hhd, Hhd, Hhd^Fdf, Hhd, Re^Edb, Rb^Edb, Rb^Edb, Re, Re, Re^Edt, Rb^Edt, Re^Edt, Re^Edt, Gll^Feth, Hhd, Hhd, Hhd^Fdf, Gs^Fdf, Re, Gs^Fdf, Gs^Fdf, Gs^Fdf, Gd, Gd^Vh, Gs^Fdf, Gs^Fdf, Gs^Fdf, Gs, Gs, Gs^Vh, Re, Gs, Re, Gs^Fdf, Gs, Gs, Gs, Gs, Gs^Fdf, Gs^Fmf, Gs^Fp
Hhd^Fdf, Hhd^Fdf, Hhd^Fdf, Hhd, Hhd, Re^Ecf, Rb^Edb, Re^Edb, Re^Edb, Ce, 2 Ke^Edb, Ce, Rb, Rb^Edt, Gll^Fdw, Gll^Fdw, Gs^Fdf, Gs^Fdf, Gs^Vhr, Gs^Fdf, Gs^Fdf, Gs^Fdf, Re, Gs, Gs, Gs, Re, Gs, Gd, Gs, Re, Re, Gd, Gs, Gs^Fdf, Gs^Fdf, Gs^Fdf, Gs^Fdf, Gs^Fmf, Gs^Fdf, Gs^Fp, Gs^Fp
Gs^Fdf, Hhd^Fdf, Hhd^Fdf, Hhd, Hhd, Hhd, Rb^Vhr, Re, Rb^Edb, Ce^Edb, Rb, Ce^Edb, Re^Edb, Re, Gll^Fdw, Gll^Vhr, Gs^Fdf, Gs^Fdf, Gs^Fdf, Gs^Fdf, Gs, Gs, Gd, Re, Re, Re, Ss, Re, Re, Re, Gd, Gd, Gs, Gd, Gs^Fdf, Gs^Fmf, Gs^Fdf, Gs^Fmf, Gs^Fdf, Gs^Fdf, Gs^Fmf, Gs^Fp
Gs^Fdf, Gs^Fdf, Gs^Fdf, Hhd, Hhd^Fdf, Hhd, Hhd, Rb, Re, Rb, Ss, Rb^Edb, Re^Ecf, Re, Gll^Fdw, Gll^Fdw, Gs^Fdf, Gs^Fdf, Gs^Fdf, Gs^Fdf, Gs, Gs^Es, Re, Gd, Re, Re, Gs, Gs, Rr, Gs, Gs, Rd, Gs, Gs^Vh, Gs^Fdf, Gs^Fdf, Gs^Fmf, Gs^Fdf, Gs^Fdf, Gs^Fmf, Gs^Fp, Gs^Fp
Gs, Gs, Re, Gs^Fdf, Gs^Fdf, Gs^Fdf, Gll, Re, Re, Ss, Ss, Re, Re^Vhr, Re, Gs, Gs^Fdf, Gs, Gs^Fdf, Gs^Fdf, Gs^Fdf, Gs, Re, Gs, Re, Gs, Re, Gd, Gs, Rr, Gs, Chr, Chr, Chr, Gs, Gs, Gs^Fmf, Gs^Fmf, Gs^Fmf, Gs^Fdf, Gs^Fmf, Gs^Fmf, Gs^Fp
Gs, Gs, Gs, Gs^Fdf, Gs^Fdf, Gs^Fdf, Gd, Gll^Fetd, Re, Ss, Gs^Fdf, Gs^Fdf, Gs^Fdf, Gs^Fdf, Gs^Fdf, Gs, Re^Es, Gs, Gs^Fdf, Gs, Re, Re, Gd, Gs^Vh, Gs^Fdf, Gs, Gs, Gs, Rr, Rr, Chr, 1 Khr, Chr, Gd, Gs, Gs^Fdf, Gs^Fmf, Gs^Fdf, Hhd^Fmf, Gs^Fmf, Gs^Fdf, Gs^Fmf
Wwr, Ww, Ww, Gs, Gs, Re, Re, Re, Re, Gd, Gs^Fdf, Gs^Fdf, Gd, Gs, Gd, Gs, Gd, Gs, Gd, Gs, Gs, Gs, Gs, Gs^Fdf, Gs^Fdf, Gs^Fdf, Gs^Fdf, Re, Gd, Re, Re, Chr, Re, Re, Gs, Gs, Hhd, Hhd^Fdf, Hhd^Fdf, Gs^Fmf, Gs, Gs
Ww, Ww, Ww, Ww, Gs, Gs, Gs^Vhr, Re, Gd, Re, Re, Gd^Es, Re, Gd, Gs, Re, Gd^Es, Gd, Rb^Gvs, Rb^Gvs, Re^Gvs, Gs, Gs^Fdf, Gs^Fdf, Gs^Fdf, Gs, Gd, Rr, Gd, Gd, Gs, Gs, Ss, Ss, Gs, Hhd, Hhd^Fdf, Hhd, Hhd^Fdf, Gs^Fdf, Gd, Gd
Gs, Gs, Wwr, Ww, Ww, Wwr, Ww, Gs, Ww, Re, Ww, Re, Re, Gd, Re, Gd, Re, Gd, Gd, Gll, Gd, Gs, Gd, Gd^Vh, Gs, Gs, Gd, Re, Gd, Gd, Gd^Vh, Gs, Ss, Ss, Gs, Gs, Hhd^Fdf, Hhd, Gs^Fdf, Gs, Rd, Gd
Gs^Fdf, Gs^Fdf, Hhd^Fdf, Ww, Ww, Ww, Ww, Ww, Ww, Ww, Ww, Ww, Ww, Re, Re, Gd, Gs, Gs^Fdf, Gs^Fdf, Gd, Re, Ss, Ss, Gs, Gd, Gs, Re, Chr, Re, Gs, Gs, Gs, Gs, Gs, Gs^Fdf, Gs, Gs^Fdf, Gs^Fdf, Gs^Fdf, Gs^Fdf, Gs, Rd
Hhd, Hhd^Fdf, Hhd^Fdf, Gs^Fdf, Hhd, Gs, Gs^Fdf, Ww, Ss, Ss, Gs, Ww, Ww, Ww, Ww, Gs, Gs, Gs^Fdf, Gd, Gd, Gs, Ss, Gd, Gd, Rr, Rr, Gs^Eff, Gd^Eff, Gs^Eff, Re, Re, Gd, Gs, Gs^Vh, Gs^Fdf, Gs^Fdf, Gs^Es, Gs^Fdf, Gs^Fdf, Gs^Fdf, Re^Eff, Gs^Eff
Hhd, Hhd, Hhd, Hhd, Gs, Gs, Gs^Fdf, Gs, Ss, Ss, Gs, Gd, Gs, Ww, Ww, Ww, Gd, Gs, Rb^Gvs, Gd, Gs, Gd, Re, Re, Gd^Eff, Gll^Eff, Rb^Edt, Rb^Gvs, Rb^Gvs, Gd, Re, Gs, Re, Gs^Fdf, Gs^Fdf, Gs^Fdf, Re, Gs^Wm, Gd^Eff, Gs^Eff, Re^Gvs, Re^Gvs
Hhd, Hhd, Hhd, Hhd, Hhd, Hhd^Fdf, Hhd^Fdf, Gs, Gs, Gd, Hhd, Gs, Gd, Gs^Fdf, Ww, Ww, Gs, Rb^Gvs, Rb^Gvs, Gd, Chr, Re, Gd, Gs, Gd, Gs^Eff, Gs^Fdf, Re^Gvs, Rb^Gvs, Gll^Dr, Re, Gs^Es, Gd, Gs, Gs, Gs, Gd, Gs^Eff, Gs^Eff, Re^Gvs, Re^Gvs, Re^Gvs
Hhd, Hhd, Hhd^Fdf, Hhd, Hhd^Fdf, Hhd, Hhd, Gs, Hhd, Gs, Gs, Gs, Gs, Gs^Fdf, Gs^Fdf, Ww, Ww, Rb^Gvs, Gs, Gs, Re, Re, Gd, Gs, Gs, Gs^Fdf, Gs^Fdf, Rb^Gvs, Gd^Es, Re, Gs^Edt, Gs^Edt, Gs, Re, Gs, Re, Re, Gs^Fdf, Gs, Gs, Gs^Eff, Re^Gvs
Hhd, Hhd^Fdf, Hhd^Fdf, Hhd, Hhd^Fdf, Hhd, Hhd, Hhd, Gs, Gs, Hhd, Hhd, Hhd, Gs, Gs, Ww, Ww, Ww, Gs^Vh, Re, Gs^Fdf, Gd, Gs, Gd, Gs^Fdf, Gs^Fdf, Gs^Es, Gs, Gs, Re, Gs^Edt, Re, Gs, Re^Es, Gs, Gd, Gs^Edb, Gll^Dr, Gs^Edb, Gd, Gs, Gs^Eff
Gs^Fdf, Gs^Fdf, Gs^Fdf, Gs^Fdf, Gs^Fdf, Gs^Fdf, Gs^Fdf, Gs^Fdf, Gd, Gs^Fdf, Gs^Fdf, Hhd, Gd^Vhr, Hhd, Gd, Gs, Ww, Ww, Ww^Bw/r, Re, Gs^Fdf, Gs, Gs, Re, Gs^Fdf, Gs^Fdf, Gs^Fdf, Gs, Gd^Es, Re, Gs, Gs, Ss, Gs, Gs^Fdf, Gs, Gs^Fdf, Re^Edb, Gs^Fdf, Gs, Gd^Es, Gd
Gs^Fdf, Gs^Fdf, Ww, Ww, Ww, Gs^Fdf, Ww, Gs^Fdf, Ss, Gs, Gs^Fdf, Gs^Fdf, Gs, Gd, Gs, Gs, Re, Ww^Bw/r, Ww, Ww, Ww, Gs^Fdf, Gs^Fdf, Re, Gs^Fdf, Gs^Fdf, Gs, Re, Gs, Re, Gs, Ss, Ss, Re, Re, Gs^Fdf, Gs, Gs^Fdf, Gs^Fdf, Gs, Gs, Gs
Ww, Ww, Gs^Qhhf, Gs^Qhh, Gs^Qhh, Ww, Gd^Qhh, Ww, Ww, Ww, Ww, Gll, Chr, Gd, Re, Re, Gs^Vh, Ww, Ww, Wo, Ww, Gs^Fdf, Gs^Fdf, Gs, Gs, Gs^Fdf, Gs^Fdf, Gg^Vhr, Gd, Re, Gd, Ss, Ss, Ss, Re, Re, Re, Gs^Fdf, Gs, Gs, Gs^Fdf, Gs^Fdf
Gs^Qhhf, Gs^Qhhf, Gs^Fdf, Gs^Fdf, Gs^Fdf, Gs^Qhhf, Gs, Gs^Qhh, Gs^Qhh, Gd^Qhh, Gs^Qhh, Ww, Ww^Bw/r, Re, Ss, Gs, Gs, Hhd, Ww, Wo, Wo, Ww, Re, Re, Re, Gs^Fdf, Gs, Gs, Gs, Re, Gs, Ss, Ss, Ss, Re, Gd, Gs^Es, Gs, Gs^Fdf, Gs^Fdf, Gs^Fdf, Gs^Fdf
Gs^Fdf, Gs^Fdf, Gs^Fdf, Gs^Fdf, Re, Gs^Fdf, Gs, Gs^Fdf, Gs^Fdf, Gd^Es, Gd^Vhr, Re^Qhh, Gs^Qhh, Ww, Ww, Gs, Gs, Gs^Vh, Re, Ww, Wo, Ww, Ww, Re, Re, Re, Re, Gd, Gs, Re, Gs^Vhr, Gs, Re, Ss, Re, Gs, Gs^Fdf, Gs^Fdf, Gs^Fdf, Gs^Fdf, Gd, Gd
Hhd^Fdf, Gs^Fdf, Hhd^Fdf, Gs^Fdf, Gs, Gs, Hhd, Hhd, Gs, Gd, Gd, Re, Gd, Gs^Qhh, Gs^Qhh, Ww, Ww, Ww, Ww, Ww, Ww, Wo, Wo, Ww, Ww, Ww, Ww, Re, Gs^Edt, Re, Re^Edt, Gs, Gs, Gd, Gd, Gs, Gs^Fdf, Gs^Fdf, Gs^Fdf, Gs^Fdf, Gs^Fdf, Gd
Hhd^Fdf, Hhd^Fdf, Hhd, Hhd, Hhd, Hhd, Hhd, Gs, Hhd, Gd, Gs, Rr, Gd, Gd, Gs^Fdf, Gs^Qhh, Gs^Qhh, Gs^Qhhf, Gs^Qhhf, Gs^Qhhf, Gs^Qhh, Ww, Ww, Wo, Wo, Wo, Wo, Ww, Ww, Gs^Edt, Re^Edt, Gs, Ww, Ss, Ww, Gs^Fdf, Gs, Gs^Fdf, Gd, Gs^Fdf, Gs^Fdf, Gs^Fdf
Hhd, Hhd, Hhd^Fdf, Hhd^Fdf, Hhd, Hhd, Hhd, Hhd, Hhd, Hhd, Gs^Es, Re, Gs, Gs^Fdf, Gs^Fdf, Gs^Fdf, Re^Gvs, Gs^Es, Re^Gvs, Gs^Fdf, Gs, Ss^Qhu, Ss^Qhu, Ww^_ml, Ww, Ww, Ww, Wo, Wo, Ww, Ww^Bw|, Ww, Wo, Ww, Wo, Ww, Ww, Ss, Ss, Gs^Fdf, Gs^Fdf, Gs^Fdf
Hhd, Hhd, Hhd, Hhd^Fdf, Hhd, Hhd, Gs, Gs, Gd^Vhr, Gd, Re, Rr, Rr, Gs, Gs, Gs, Rb^Gvs, Rb^Gvs, Rb^Gvs, Gs, Ss^Qhu, Ss^Qhu, Ss^Qhu, Ss^Qhu, Gll^Qhhf, Gs^Qhh, Gs^Qhh, Ww, Ww, Ww, Ww^Bw|, Ww, Wo, Wo, Wo, Wo, Wo, Ww, Ww, Gs, Gs, Gs
Hhd, Hhd, Hhd, Hhd, Hhd, Hhd^Fdf, Gll^Fdw, Gll^Fdw, Re, Rb^Edt, Rb^Edt, Re^Edt, Re^Edt, Rr, Re, Gs, Gd^Vhr, Rb^Gvs, Gll, Gs, Gs, Ss^Qhu, Gll^Fdf, Ss^Qhu, Gll^Fdf, Re, Gs^Fdf, Ss^Qhh, Ss^Qhh, Ss^Qhh, Re, Ww, Ww, Ww, Ww, Ww, Ww, Wo, Wo, Ww, Ww, Ww
Hhd, Hhd, Hhd, Hhd, Gs, Gs, Gs^Fdf, Gll^Fdw, Gll^Fdw, Rb^Edt, Ch, Rp^Edt, Chr, Rb^Edt, Rb, Gs, Gd, Gs, Ss^Qhu, Gs, Gs^Fdf, Gs, Gs, Gll^Fdf, Gd, Gd, Gs, Gs^Fdf, Gs^Fdf, Ket, Re, Gd^Vht, Ss, Ss, Ss, Hhd^Qhh, Hhd^Qhh, Ww, Ww, Wo, Wo, Wo
Hhd, Hhd, Hhd, Hhd, Gs, Gs, Hhd^Fdf, Hhd^Fdf, Re^Ecf, Rp, Ch^Edb, 3 Khr, Chr, Rb, Re^Es, Gs, Gs, Gd^Es, Gs, Gd, Gs^Fdf, Gs^Fdf, Gs^Fdf, Gd, Gd, Gs^Vht, Gs, Gs^Fdf, Gll, Gd, Gd, Re, Gll^Gvs, Ss, Gs^Vht, Hhd, Re, Re, Re, Ww, Ww, Ww
Hhd^Fdf, Hhd^Fdf, Hhd^Fdf, Hhd, Gs, Hhd^Fdf, Hhd^Fdf, Gll^Fdw, Rb^Fetd, Rp, Rb^Edb, Rp^Edb, Re, Re, Re, Hhd, Hhd, Gs, Gs, Gs, Gs^Fdf, Gs^Fdf, Gs^Fdf, Gs^Fdf, Re, Re, Re, Ket, Gll, Gll, Gll, Re, Re, Gll^Gvs, Gll^Gvs, Re, Gs^Qhhf, Gs^Qhhf, Gs^Qhhf, Gs^Vht, Gs^Qhhf, Gs^Qhhf
Hhd, Hhd, Hhd^Fdf, Hhd^Fdf, Hhd^Fdf, Gs^Fdf, Gll^Fdw, Gll^Fdw, Gll^Fdw, Re, Re^Edb, Rb, Hhd, Hhd, Re, Gs, Hhd, Hhd, Gs, Gs^Es, Gs, Gs^Fdf, Re, Re, Gs, Gs^Fdf, Gs^Fdf, Re, Re, Gd, Chr, Chr, Rp, Re, Re, Re, Re^Qhh, Gs^Fdf, Gs^Fmf, Gs^Qhhf, Gs^Fmf, Gs^Fmf
Hhd, Hhd, Hhd, Hhd^Fdf, Gs^Fdf, Gs^Fdf, Gs^Fdf, Gll^Vhr, Gll^Fdw, Re, Re, Re, Gll^Edb, Hhd, Re, Gs, Hhd, Hhd, Gs, Gd, Re, Re, Gs^Fdf, Gs^Fdf, Gs^Fdf, Gs^Fdf, Gs^Fdf, Gs^Fdf, Gll, Re, Gll^Ebn, 4 Khr, Ce^Qhh, Re, Gll^Qhh, Ket^Qhh, Re, Gs^Fdf, Gs^Fdf, Gs^Fmf, Gs^Fmf, Gs^Fp
Hhd, Hhd, Hhd, Hhd^Fdf, Gs^Fdf, Gs^Fdf, Gs^Fdf, Gll^Fdw, Hhd, Hhd, Gs^Edb, Gd^Edb, Rr, Rr, Gs, Gs^Vhr, Re, Gs, Re, Re^Edb, Re, Gs, Gs, Gs^Fdf, Gs^Fdf, Gs^Fdf, Gs^Fdf, Ket, Ss^Qhu, Gll, Gll^Qhh, Ce^Qhh, Rp, Gll^Qhh, Rp, Gd, Re, Gs^Fmf, Re^Gvs, Gs^Fmf, Gs^Fmf, Gs^Fp
Hhd, Hhd, Hhd, Hhd, Hhd, Gs^Fdf, Hhd, Hhd, Hhd, Hhd, Gs^Edb, Rr^Edb, Gs, Gs, Hhd, Gs, Gs, Re, Gd, Gll^Dr, Gd, Re, Gs^Vht, Gs^Fdf, Gs^Fdf, Gs^Fdf, Gs^Vht, Ss^Qhu, Ss^Qhu, Ss^Qhu, Gll^Qhh, Gd, Rp, Rp, Rp, Gd^_mhh, Re, Gs^Vht, Gll^Gvs, Gs^Fdf, Gs^Fmf, Gs^Fp
Hhd, Hhd, Hhd, Hhd, Hhd, Hhd, Hhd, Hhd, Gs, Gs^Edb, Re^Edb, Re, Gs^Es, Hhd, Hhd, Hhd, Gs, Gs^Es, Gd, Gd, Gd, Re, Gs, Gs^Fdf, Gs^Fdf, Gs^Fdf, Gs, Ss^Qhu, Ss^Qhu, Ss^Qhu, Ss^Qhu, Gll^Qhh, Gll^Fdf, Gll, Gll^Fmf, Gs, Re, Gll^Gvs, Re^Ecf, Re, Gs^Fdf, Gs^Fp
Hhd^Fdf, Hhd, Hhd^Fdf, Hhd, Hhd, Hhd, Hhd, Hhd, Hhd, Gs^Edb, Re, Gd^_mh, Gd, Gd, Hhd, Hhd, Hhd, Gs, Hhd, Gd, Gs, Re, Gs^Eff, Gs^Eff, Gs^Eff, Gs, Re, Gs, Gs, Gs^Qhhf, Gll^Fdf, Gs^Qhhf, Gs^Fdf, Gll^Fdf, Gs^Fmf, Ket, Re, Ket, Gs^Fmf, Gs^Fdf, Gs^Fmf, Gs^Fdf
Gd^Fdf, Gd^Fdf, Hhd^Fdf, Hhd^Fdf, Hhd^Fdf, Hhd, Hhd, Hhd, Hhd, Gs^Edb, Re^Edb, Gd, Gd^Edt, Gs, Hhd, Hhd, Hhd, Hhd, Hhd, Gs, Gs^Eff, Re, Gll^Gvs, Gs^Gvs, Rb^Gvs, Gs^Eff, Gs^Eff, Gs, Gs, Gs^Qhhf, Gs^Fdf, Gs^Fdf, Gs^Fmf, Gs^Fmf, Gs^Fmf, Gs^Fdf, Re, Gs^Fdf, Gs^Fmf, Gs^Fmf, Gs^Fp, Gs^Fp
Gd^Fdf, Gd^Fdf, Gd^Fdf, Hhd^Fdf, Hhd^Fdf, Hhd, Hhd, Hhd, Hhd, Gd, Gd, Re, Re, Gs^Edt, Gs, Hhd, Hhd^Fdf, Hhd, Hhd, Gs^Eff, Gs^Gvs, Gll^Gvs, Gd^Gvs, Gll^Wm, Gs^Gvs, Rb^Gvs, Rb^Gvs, Gs^Eff, Gd^Qhhf, Gd^Qhhf, Gd^Fdf, Gll^Fdf, Gll^Fmf, Gll^Fmf, Gll^Fmf, Gs, Re, Gs, Gll^Fmf, Gll^Fmf, Gll^Fp, Gll^Fp
Hhd^Fdf, Hhd^Fdf, Hhd^Fdf, Gd^Fdf, Gd^Fdf, Hhd, Hhd, Hhd, Hhd, Hhd, Gs^Es, Gll, Re, Gll^Edt, Gll^Edt, Hhd^Fdf, Hhd^Fdf, Hhd^Fdf, Hhd, Hhd, Hhd, Rb^Gvs, Rb^Gvs, Rb^Gvs, Rb^Gvs, Rb^Gvs, Rb^Gvs, Gs, Gd^Qhhf, Gd^Fdf, Gd^Fdf, Gll^Fmf, Gll^Fmf, Gll^Fmf, Gll^Fmf, Gs, Gs, Re, Gs, Gll^Fp, Gll^Fp, Gll^Fp
Hhd, Hhd^Fdf, Gd^Fdf, Gd^Fdf, Hhd^Fdf, Hhd^Fdf, Hhd, Hhd, Hhd, Hhd, Gs, Gs, Re, Gll^Edt, Gs, Gd^Fdf, Hhd^Fdf, Hhd^Fdf, Hhd, Hhd, Gs, Re^Gvs, Rb, Rb^Gvs, Gs^Gvs, Gs^Gvs, Gg^Gvs, Gs, Gd^Qhhf, Gd^Fdf, Gg, Gll^Fmf, Gll^Fmf, Gll^Fmf, Gg, Gg, Gs, Re, Gs, Gll^Fp, Gll^Fp, Gll^Fp
