Gd^Fdf, Gd, Gd^Fp, Gd^Fp, Gd^Fmf, Gd^Fmf, Gll^Fdw, Gll^Fdw, Gll^Fdw, Gll^Fdw, Gd^Fmf, Gd^Fmf, Gd^Fmf, Gd^Fdf, Gd^Fdf, Gd^Fp, Gd^Fdf, Ss, Gd^Fmf, Gd^Fp, Gd^Fp, Gd^Fp
Gd^Fmf, Gd, Gd, Gd^Fp, Ce, Gd^Fp, Gd, Gll^Fdw, Gll^Fdw, Gll^Fdw, Gll^Fdw, Gs, Gd^Fmf, Gd^Fmf, Gs, Gd^Fdf, Gd^Fp, Gd^Fmf, Gd^Fp, Gd^Fp, Gd^Fp, Gd^Fp
Gd^Fp, Gd^Fmf, Gd^Fmf, Ce, 1 Ke, Ce, Gd, Gll^Fdw, Gll^Fdw, Gll^Fdw, Gd^Fp, Gd^Fp, Gd^Fp, Gs, Gd^Fmf, Gs, Gs, Gd^Fp, Gd^Fp, Gd^Fp, Gd^Fp, Gs^Fp
Gd^Fmf, Gd^Fp, Gd^Fp, Ce, Ce, Ce, Gd^Fp, Gd^Fp, Gd^Fp, Gd^Fp, Gd^Fp, Gd^Fmf, Gd^Fdf, Gd^Fmf, Gd^Fdf, Gs, Gd^Fp, Gd^Fp, Gd^Fp, Gd^Fp, Gd^Fp, Gs^Fp
Gd^Fmf, Gd^Fmf, Gd^Fmf, Gd^Fp, Gs, Gd^Fmf, Gd^Fp, Gd^Fp, Gd^Fp, Gd^Fp, Gd^Fmf, Gd^Fmf, Gd^Fdf, Gd^Fmf, Ss, Gd, Gd, Ss, Ss, Gd^Fp, Gd^Fp, Gd^Fp
Gd^Fmf, Gd^Fmf, Gd^Fp, Gd^Fmf, Gs, Gd^Fp, Gd^Fp, Gd^Fp, Gd^Fmf, Gd^Fmf, Gd^Fmf, Gd^Fdf, Gg^Fet, Ss, Ss, Gd, Gd, Gd, Ss, Gd^Fp, Gd^Fetd, Gd^Fp
Gd^Fp, Gd^Fp, Gd^Vhr, Gd^Fp, Gs, Gd^Fp, Gd^Fp, Gd^Fp, Gd^Fmf, Gd^Fdf, Gd^Fdf, Gd^Fdf, Gd^Fdf, Ss, Ss, Chr, 2 Khr, Chr, Ss, Ss, Gd^Fp, Gd^Fp
Gd^Fp, Gd^Fp, Gd^Fp, Gs, Gd^Fp, Gd^Fp, Gd^Fp, Gd^Fp, Gd^Fmf, Gd^Fdf, Gd^Fmf, Gd^Fdf, Gd^Fetd, Gd^Fdf, Ss, Chr, Ss, Chr, Ss, Ss, Gg^Fet, Gd^Fp
Gd^Fp, Gd^Fp, Gd^Fp, Gs, Gd^Fp, Gd^Fp, Gd^Fp, Gd^Fp, Gd^Fdf, Gd^Fmf, Gd^Fmf, Gd^Fdf, Gd^Fdf, Gd^Fdf, Ss, Ss, Ss, Ss, Gd^Fdf, Gd^Fdf, Gd^Fdf, Gs^Fmf
Gd^Fdf, Gd^Fp, Gd^Fp, Gd^Fp, Gd^Fp, Gd^Fp, Gd^Fp, Gd^Fp, Gll^Fdw, Gd^Fdf, Gd^Fdf, Gd^Fdf, Ss, Ss, Ss, Ss, Gd^Fdf, Gd^Fdf, Gd^Fdf, Gd^Fdf, Gd^Fdf, Gd^Fmf
Gd^Fdf, Gll^Fdw, Gll^Fdw, Gd^Fp, Gll^Fdw, Gd^Fp, Gll^Fdw, Gll^Fdw, Gll^Fdw, Gll^Fdw, Gll^Fdw, Ss, Ss, Ss, Ss, Ss, Gd^Fmf, Gd^Fdf, Gd^Fdf, Gd^Fdf, Gd^Fmf, Hh^Fmf
Gd^Fdf, Gd^Fdf, Gll^Fdw, Gll^Fdw, Gs, Gll^Fdw, Gll^Fdw, Gll^Fdw, Gll^Fdw, Gll^Fdw, Gll^Fdw, Gll^Fdw, Gd^Fp, Ss, Ss, Gd^Fmf, Gd^Fdf, Gd^Fdf, Gd^Fmf, Gd^Fmf, Gd^Fp, Hh^Fmf
