Ha, Ha, Aa, Aa, Aa, Aa, Aa^Fda, Aa, Aa, Aa, Aa, Aa, Aa, Aa, Aa, Aa^Fda, Aa^Fda, Aa^Fda, Ha^Fda, Ha, Ai, Ha, Ha, Ha, Aa, Ww, Ww, Ww, Ww, Ww, Ww, Ww
Ha, Ha, Aa, Aa, Aa, Aa^Fda, Aa^Fda, Aa^Fda, Aa, Aa, Aa, Aa, Aa, Aa^Fda, Aa, Aa^Fda, Aa^Fda, Aa^Fda, Ha, Ha, Ai, Ha, Ha, Ha, Aa, Ww, Ww, Cme, Cme, Ww, Ww, Ww
Ha, Ha, Ha, Aa, Aa^Fda, Aa^Fda, Ai, Aa^Fda, Ha^Fda, Ha^Fda, Ha, Aa^Vha, Ha, Ha^Fda, Ha, Aa, Gd^Esa, Ha^Fda, Ha^Fda, Ai, Ai, Ha, Ha, Ww^Vm, Ww, Ww, Ww, Ww, Cme, Ww, Ww, Ww
Ha, Ha^Fda, Aa^Fda, Ha^Vhha, Aa^Fda, Aa^Fda, Aa^Fda, Aa^Fda, Ha, Ha, Ms, Ha, Ha, Ha, Ha, Ha, Ha, Ha^Fda, Ha, Ha, Ha, Ha, Gd^Esa, Gd, Aa^Fda, Ww, Ww, 4 Kme, Cme, Ww, Wo, Wo
Ha^Fda, Ha^Fda, Aa^Fda, Aa, Ce, Ce, Ce, Aa, Ha, Ha, Ms, Ms, Ha, Ha^Fda, Ha^Fda, Ha, Ha, Ha, Ha, Ha, Ha, Ha, Gd^Esa, Aa^Fda, Aa^Fda, Ww, Ww, Cme, Cme, Ww, Wo, Wo
Ha, Aa^Fda, Aa^Fda, Aa, Ce, 1 Ke, Ce, Aa, Ha, Ha, Ha, Ha^Fda, Aa^Fda, Aa^Fda, Aa^Fda, Aa^Fda, Re, Gd^Vh, Re, Re, Re, Gd, Ha, Ha^Fda, Aa^Fda, Ww, Ww, Ww, Ww, Ww, Wo, Wo
Re, Re, Re, Aa, Aa^Fda, Ce, Aa^Fda, Aa^Fda, Aa^Fda, Ha, Ha, Ha^Fda, Aa^Fda, Aa^Fda, Aa, Aa, Re, Re, Aa, Aa, Aa, Re, Re, Gd^Esa, Gd, Aa, Ww^Vm, Ww, Ww, Ww, Wo, Wo
Re, Ha, Ha, Re, Aa, Aa^Fda, Aa^Fda, Aa^Fda, Aa, Ha, Aa^Vha, Aa^Fda, Re, Aa, Re, Re, Aa, Aa, Ai, Aa, Aa, Aa, Aa, Re, Re, Aa, Ai, Ai, Ww, Wo, Wo, Wo
Ha, Ha, Ha, Re, Re, Aa^Fda, Re, Re, Re, Aa, Aa, Re, Re, Re, Aa, Aa, Aa, Ai, Ww, Ww, Ww, Ai, Ai, Gd, Gd, Gd, Ai, Ww, Ww, Wo, Wo, Wo
Ha^Fda, Ai, Ha, Aa, Aa, Re, Aa^Fda, Aa^Fda, Re, Re, Re, Re, Gd, Gd^Vh, Ww, Ww, Ww, Ww, Ww, Wo, Wo, Ww, Ww, Ww, Ww, Ww, Ww, Ww, Wo, Wo, Wo, Wo
Aa, Ha, Aa, Aa, Aa, Aa, Aa, Aa, Gd^Vh, Re, Aa, Aa, Wwf, Ww, Wo, Ww, Wo, Wo, Wo, Wo, Wo, Wo, Wo, Ww, Ww, Ww, Wo, Ww, Wo, Wo, Wo, Wo
Aa, Aa, Gd, Aa, Ai, Gd, Re, Gd, Ai, Gd, Wwf, Aa, Wwf, Wo, Wo, Wo, Wo, Wo, Wo, Wo, Wo, Wo, Ai, Wo, Wo, Ww, Ww, Wo, Wo, Wo, Wo, Wo
Ww, Ww, Ww, Ww, Wo, Ww, Ww^Bw|, Ww, Ww, Ww, Wo, Wwf, Wwf, Wwf, Wwf, Wo, Wo, Wo, Wwf^Edb, Wo, Wwf^Edb, Wo, Ai, Ai, Wo, Ww, Ai, Ww, Ww, Wo, Wo, Wo
Wo, Wo, Wo, Wo, Wo, Wo, Wo^Bw|, Wo, Wo, Wo, Wo, Wo, Wo, Wwf, Wwf, Wwf, Wwf, Wwf, Ww, Wwf^Edb, Wo, Ai, Ai, Ai, Gd, Gd^Vhr, Aa, Ai, Ww, Wo, Ai, Wo
Wo, Wo, Wo, Wo, Wo, Wo, Wo^Bw|r, Wo, Wo, Wo, Wo, Wo, Wo, Wo, Wwf, Ww, Ww, Ww, Ww, Wo, Wo, Wo, Ai, Aa, Aa, Rr, Aa, Ai, Ai, Wo, Ai, Wo
Wo, Wo, Ww, Ww, Ww, Ww, Ww^Bw|, Ww, Ww, Wo, Ww, Ww, Ww, Ww, Cha, Ww, Ww, Ww, Ww, Wo, Ww, Ww, Ai, Ds, Gd, Rr, Aa^Vhca, Ai, Aa^Fda, Ai, Ww, Ww
Ww, Ww, Gd^Vh, Ww, Gd, Ai, Ww^Bw|, Ai, Gd, Ww, Aa, Aa, Aa, Aa, Cha, Ww, Ww, Ww^Bw\, Ds^Ewsh, Ww^Bw\, Ds, Ww^Bw\, Ds, Aa, Aa^Vhca, Rr, Rr, Aa, Aa^Fda, Aa^Fda, Ww, Ww
Aa, Gd, Aa, Rd, Rd, Aa, Rd, Aa, Aa^Fda, Rd, Aa, Aa, Aa, Aa, Cha, Ai, Re^Esa, Ds, Ds, Ds, Aa^Vhca, Ds, Aa, Aa, Rr, Aa^Vhca, Rr, Ha, Aa, Ai, Ww, Ww
Aa, Aa, Aa, Aa, Aa, Aa^Fda, Aa^Fda, Aa^Vha, Re^Esa, Aa^Fda, Aa^Fda, Re^Esa, Re, Gd, Re, Cha, Cha, Gd^Vhc, Rr, Aa, Aa^Vhca, Aa, Cha, Cha, Ch, Rr, Rr^Esa, Ha, Ha, Ai, Ww, Ww
Re^Dr, Gd, Gd^Edt, Aa, Re, Aa^Fda, Rd, Rd, Rd, Gd^Fdw, Rd^Edb, Re, Chr, Re, Re, Re, Rr, Rr, Cha, Rr, Rr, Rr, Ch, 2 Kha, Ch, Rr, Ha, Ha, Aa^Vha, Ai, Ww, Ww
Rd, Rd, Rd, Rd^Edt, Rd^Edt, Rd, Aa^Esa, Gd^Fdw, Gd^Fdw, Rd, Re^Edb, Rd^Edb, Rr, Re, Rr, Rr, Re, Aa, Aa, Cha, Cha, Rr, Rr, Cha, Rr, Rr, Ha, Ha, Ai, Ai, Ww, Ww
Rd, Re, Re, Re^Edt, Aa^Edt, Re^Edt, Ha^Fda, Aa^Fda, Ha^Fda, Aa^Fda, Gd^Esa, Re, Chr, Rr, Aa^Vha, Re, Re^Esa, Aa, Re, Cha, Aa, Aa, Aa, Rr, Ha, Rr, Aa^Vhca, Aa, Ai, Ww, Ww, Ww
Rd, Gd^Vhr, Ha, Ha^Edt, Ha, Ha, Ha, Ha, Ha, Ha, Re^Esa, Re, Re^Edb, Rr^Edb, Aa, Aa, Aa, Aa, Ai, Cha, Aa^Vhca, Ha, Gd, Aa^Vhca, Aa, Ha, Aa, Ai, Ww, Ww, Wo, Wo
Rd, Ha, Ms, Ms, Ha, Ha, Ha^Fda, Cer, Aa^Fda, Ha^Fda, Ha, Ha, Rr, Rr^Edb, Re, Aa, Re, Ai, Ai, Ai, Ai, Aa, Ww, Ai, Ww, Gd, Ww, Ww, Wo, Wo, Wo, Wo
Ha, Ha, Ha^Fda, Ha, Cer, Cer, 5 Ker, Cer, Cer, Gd^Fdw, Rr, Rr, Aa, Re, Gd^Fdw, Aa, Re, Ai, Ww, Ww, Ww, Ww, Wo, Ww, Ww, Ww, Ww, Ww, Wo, Wo, Wo, Wo
Ha, Ha, Aa^Fda, Aa^Fda, Gd, Gd, Cer, Rd^Ecf, Rd^Edb, Rd^Edb, Aa^Edb, Aa, Aa, Aa^Fda, Aa^Fda, Gd^Vha, Ai, Ai, Ww, Ww, Wo, Wo, Wo, Wo, Wo, Ww, Ww, Ww, Wo, Wo, Wo, Wo
Re, Ha, Gd^Fdw, Aa^Fda, Rd, Rd, Aa, Aa, Ai, Aa^Edb, Ai, Ai, Ai, Ai, Ai, Ai, Ww, Ai, Ww, Ww, Wo, Wo, Wo, Wo, Wo, Ww, Ww, Ww, Wo, Wo, Wo, Wo
Re^Edb, Rd^Edb, Rd^Edb, Rd, Aa, Aa, Ai, Aa, Ai, Ai, Ww, Ai, Ww, Ww, Ww, Ww, Ww, Ww, Wwr, Ww, Ww, Wo, Ww, Wo, Wwr, Ww, Ww, Ww, Wo, Wo, Wo, Wo
Re^Edb, Re^Edb, Rd^Edb, Aa^Edb, Aa, Ai, Ai, Ai, Ww, Ww, Ww, Ww, Ww, Ww, Ww, Ww, Wo, Wwr, Wwr, Ww, Wwr, Ww, Ww, Wwr, Wwr, Ww, Ww, Ww, Wo, Wo, Wo, Wo
Gd^Fdw, Re, Rd, Aa, Aa, Aa, Ai, Ai, Ww, Ww, Wo, Ww, Wo, Ww, Wo, Wo, Wo, Wo, Wo, Wwr, Ww, Ww, Ww, Ww, Wwr, Ww, Ww, Wo, Wo, Wo, Wo, Wo
Gd, Re, Gd^Fdw, Rd, Rd, Re, Re, Ai, Wwr, Wwr, Wo, Wo, Wo, Wo, Wo, Wo, Ww, Ww, Ww, Ww, Gd^Esa, Ww^Vm, Ai, Ww, Wwr, Ww, Wo, Wo, Wo, Wo, Wo, Wo
Aa, Gd^Fdw, Aa^Fda, Aa^Fda, Aa^Fda, Re, Gd, Ww, Ww, Ww, Wwr, Wo, Wo, Wo, Wo, Ww, Ai, Ai, Aa^Fda, Ai, Aa^Vha, Ha, Ai, Wwr, Ww, Ww, Wo, Wo, Wo, Wo, Wo, Wo
Gd, Aa^Fda, Aa^Fda, Aa^Fda, Aa^Fda, Aa^Fda, Ww, Ww, Ai, Ww, Ww, Wwr, Wwr, Wwr, Ww, Ww, Ww^Bw\, Aa^Fda, Gd^Esa, Aa, Ha, Ha^Fda, Ai, Ww, Ww, Cme, Wo, Wo, Wo, Wo, Wo, Wo
Gd, Ai, Ai, Ai, Ww, Ai, Ww, Ai, Ww, Ww, Wo, Wwr, Wwr, Ww, Wwr, Ww, Ai, Gd^Vh, Aa^Fda, Ha, Ha^Fda, Ai, Ww, Ww, Cme, Cme, 3 Kme, Wo, Wo, Wo, Wo, Wo
Ai, Ai, Ai, Ww^Vm, Wo, Ww, Wo, Wo, Wo, Wo, Wo, Wo, Wo, Wo, Wo, Ww, Ai, Ai, Ai, Ai, Ai, Ai, Wo, Ww, Cme, Wo, Wo, Wo, Wo, Wo, Wo, Wo
Ai, Ww, Ww, Ww, Ww, Wo, Wo, Wo, Wo, Wo, Wo, Wo, Wo, Wo, Wo, Ww, Ww, Ww, Ww, Ww, Wo, Wo, Wo, Wo, Cme, Cme, Wo, Wo, Wo, Wo, Wo, Wo
Ai, Ww, Ww, Ww, Ww, Wo, Wo, Wo, Wo, Wo, Wo, Wo, Wo, Wo, Wo, Wo, Wo, Wo, Wo, Wo, Wo, Wo, Wo, Wo, Wo, Wo, Wo, Wo, Wo, Wo, Wo, Wo
