Gll^Fdw, Gd^Fdf, Gd, Re, Gs, Gll^Fdw, Gll^Fdw, Gll^Fdw, Gll^Fdw, Gll^Fdw, Gll^Fdw, Gll^Fdw, Gll^Fdw, Gd^Fdf, Gd^Fmf, Gd^Fmf, Gd^Fp, Gd^Fp, Gd^Fp, Ww, Ww, Gd^Fp, Gd^Fp, Gs, Gd^Fp, Gd^Fp, Gd^Fp, Gd^Fp, Gd^Fp, Gd^Fp, Gd^Fp, Gd^Fp
Gll^Fdw, Gll^Fdw, Gd, Re, Gd^Vhr, Gll^Fdw, Gll^Fdw, Gll^Fdw, Gll^Fdw, Gll^Fdw, Gll^Fdw, Gll^Fdw, Gd^Fmf, Gd^Fmf, Gd^Fmf, Gd^Fmf, Gd^Fp, Gd^Fp, Gs^Fp, Ww, Ww, Gd^Fp, Gd^Fp, Gd^Vhr, Gd^Fp, Gd^Fp, Gd^Fp, Gd^Fp, Gd^Fp, Gd^Fp, Gd^Fp, Gd^Fp
Gll^Fdw, Gll^Fdw, Gd^Vhr, Re, Re, Gd^Fmf, Gd^Fmf, Gll^Fdw, Gd^Fmf, Gd^Fmf, Gd^Fmf, Gd^Fmf, Gd^Fmf, Gd^Fmf, Gd^Fmf, Gd^Fp, Gd^Fp, Gd^Fp, Gs^Fp, Gs^Fp, Gd^Fp, Ww, Ww, Gd^Fp, Gd^Fp, Gd^Fp, Gd^Fp, Cer, 3 Ker, Cer, Gd^Fp, Gd^Fp
Gll^Fdw, Gll^Fdw, Gll^Fdw, Gs, Gll^Fdw, Gd, Re, Gd^Fmf, Gd^Fmf, Gd^Fmf, Gd^Fmf, Gd^Fmf, Gd^Fmf, Gd^Fmf, Gd^Fmf, Ss, Gd^Fp, Gd^Fp, Gs^Fmf, Gs^Fp, Gd^Fp, Ww, Ww, Gd^Fp, Gd^Fp, Gd^Fp, Gd^Fp, Cer, Rd, Cer, Gd^Fp, Gd^Fp
Gll^Fdw, Gll^Fdw, Gll^Fdw, Gll^Fdw, Gll^Fdw, Gll^Fdw, Re, Re, Re, Gd^Fmf, Gd^Fmf, Gd^Fmf, Gd^Fmf, Gd^Fmf, Gd^Fmf, Gd^Fmf, Gd^Fdf, Gd^Fmf, Gd^Fmf, Gd^Fp, Gd^Fp, Gd^Fp, Gs^Fp, Ww, Ww, Gd^Fp, Gd^Fp, Gd^Fp, Rd, Gd^Fp, Gd^Vhr, Gg
Gll^Fdw, Gll^Fdw, Gll^Fdw, Gll^Fdw, Ce, Ce, Ce, Gd^Fmf, Gd^Fdf, Gd, Gd, Gd^Fmf, Gd^Fmf, Gd^Fmf, Gd^Fmf, Ss, Ss, Gd^Fdf, Gd^Fdf, Gd^Fmf, Gd^Fmf, Gs^Fp, Gs^Fp, Ww, Ww, Gd^Fp, Gd^Vhr, Gd^Fp, Gd^Fp, Gd^Fp, Gd^Fp, Gd^Fp
Gll^Fdw, Gll^Fdw, Gd^Fdf, Gd^Fmf, Ce, 1 Ke, Ce, Gd^Fdf, Gd^Vhr, Gd^Fmf, Gd^Fmf, Gd^Fmf, Gd^Fmf, Gd^Fmf, Gd^Fdf, Ss, Gd^Fdf, Gd^Fdf, Gd^Fmf, Gd^Fmf, Gd^Fp, Gd^Fp, Gd^Fp, Gd^Fp, Ww, Gd^Fp, Gd^Fp, Rd, Gd^Vhr, Gd^Fp, Gd^Fp, Gd^Fp
Gd^Fdf, Gd^Fmf, Gd^Fmf, Gd^Fmf, Gd^Fmf, Ce, Gd^Fdf, Gd^Fmf, Gd, Gd, Gd^Fmf, Gd^Fmf, Gd^Fmf, Gd^Fmf, Gd^Fdf, Gd^Fdf, Ss, Gd^Fmf, Gd^Fdf, Gd^Fmf, Gd^Fmf, Gd^Fp, Gd^Fp, Gd^Fp, Gd^Fp, Ww, Rd, Rd, Rd, Gd^Fp, Gd^Fp, Gd^Fp
Gd^Fdf, Gd^Fdf, Gd^Fmf, Gd^Fp, Gd^Fp, Gd^Fmf, Gd, Gd, Gs, Gd^Fmf, Gd^Fmf, Gd^Fmf, Gd^Fmf, Gd^Fmf, Gd^Fp, Ss, Ss, Gd^Fp, Gd^Fp, Gd^Fmf, Gd^Fmf, Gd^Fp, Gd^Fp, Gd^Fp, Rd, Ww^Bw/, Ww, Gd^Fp, Gd^Fp, Rd, Gd^Fp, Gd^Fp
Gd^Fdf, Gd^Fdf, Gd^Fmf, Gd^Fp, Gd^Fp, Gd^Fmf, Gd, Gll^Fdw, Gll^Fdw, Gs, Gs, Gd^Fmf, Gd^Fmf, Gd^Fmf, Ss, Ss, Ss, Ss^Vhs, Gd^Fdf, Gd^Fdf, Gd^Fp, Gd^Fp, Gs, Rd, Gd^Fp, Ww, Ww, Gd^Fp, Gd^Fp, Rd, Gd^Fp, Gd^Fp
Gd^Fdf, Gd^Fdf, Gd^Fp, Gd^Fp, Gd^Fmf, Gd^Vhr, Gs, Gll^Fdw, Gll^Fdw, Gll^Fdw, Gs, Gd^Fmf, Gd^Fmf, Gd^Fdf, Gd^Fdf, Gd^Fp, Gd^Fdf, Ss, Gd^Fmf, Gd^Fp, Gs, Gd^Fp, Gd^Fp, Gd^Fp, Gd^Fp, Gd^Fp, Ww, Gd^Fp, Gd^Fp, Gd^Fp, Gs^Fp, Gd^Fp
Gd^Fmf, Gd^Fmf, Gd^Fdf, Gd^Fp, Gd^Fmf, Gd^Fp, Gd, Gll^Fdw, Gll^Fdw, Gll^Fdw, Gll^Fdw, Gs, Gd^Fmf, Gd^Fmf, Gs, Gd^Fdf, Gd^Fp, Gd^Fmf, Gs, Gd^Fp, Gd^Fp, Gd^Fp, Gs^Fp, Gd^Fp, Gd^Fp, Gd^Fp, Ww, Gd^Fp, Gs^Fp, Gs, Gs^Fp, Gs^Fp
Gd^Fp, Gd^Fmf, Gd^Fmf, Gd^Fmf, Gd^Fmf, Gd^Fmf, Gd, Gll^Fdw, Gll^Fdw, Gll^Fdw, Gd^Fp, Gd^Fp, Gd^Fp, Gs, Gd^Fmf, Gs, Gs, Gs, Gd^Fp, Gd^Fp, Gd^Fp, Gs^Fp, Gs^Fp, Gs^Fp, Gs^Fp, Ww, Ww, Gd^Fp, Gd^Fp, Gs^Fp, Gs^Fp, Gd^Fp
Gd^Fmf, Gd^Fp, Gd^Fp, Gd^Vhr, Gs, Gd, Gd^Fp, Gd^Fp, Gd^Fp, Gd^Fp, Gd^Fp, Gd^Fmf, Gd^Fdf, Gd^Fmf, Gs^Fet, Gs, Gd^Fp, Gd^Fp, Gs^Fet, Gd^Fp, Gd^Fp, Gs^Fp, Gd^Fp, Gs^Fp, Ww, Ww, Gs^Fp, Gd^Fp, Gd^Vhr, Gd^Fp, Gs^Fp, Gs^Fp
Gd^Fmf, Gd^Fmf, Gd^Fmf, Gd^Fp, Gs, Gd^Fmf, Gd^Fp, Gd^Fp, Gd^Fp, Gd^Fp, Gd^Fmf, Gd^Fmf, Gd^Fetd, Gd^Fmf, Ss, Gd, Gd, Ss, Ss, Gd^Fp, Gd^Fp, Gd^Fp, Gd^Fp, Gd^Fp, Ww, Gs^Fp, Gs^Fp, Gd^Fp, Gd^Fp, Gs, Gs^Fp, Gd^Fp
Gd^Fmf, Gd^Fmf, Gd^Fp, Gd^Fmf, Gs, Gd^Fp, Gd^Fp, Gd^Fp, Gd^Fmf, Gd^Fmf, Gd^Fmf, Gd^Fdf, Gd^Fdf, Ss, Ss, Gs^Fet, Gd, Gs^Fet, Ss, Gd^Fetd, Gd^Fp, Gd^Fp, Gd^Fp, Gd^Fp, Ww, Gs^Fp, Gd^Fp, Gs^Fp, Gs^Fp, Gs, Gd^Fp, Gd^Fp
Gd^Fp, Gd^Fp, Gd^Vhr, Gd^Fp, Gs, Gd^Fp, Gd^Fp, Gd^Fp, Gd^Fmf, Gd^Fdf, Gd^Fdf, Gd^Fdf, Gs^Fet, Ss, Ss, Chr, 2 Khr, Chr, Ss, Ss, Gs^Fet, Gd^Fp, Gs^Fp, Gd^Fp, Ww, Gs^Fp, Gs^Fp, Gs^Fp, Gd^Fp, Gs^Fp, Gd^Fp, Gd^Fp
Gd^Fp, Gd^Fp, Gd^Fp, Gs, Gd^Fp, Gd^Fp, Gd^Fp, Gd^Fp, Gd^Fmf, Gd^Fdf, Gd^Fmf, Gd^Fdf, Gd^Fdf, Gd^Fdf, Ss, Chr, Gs^Fet, Chr, Ss, Ss, Gd^Fdf, Gd^Fp, Gs^Fmf, Gs^Fp, Ww, Gd^Fp, Gd^Fp, Gd^Fp, Gd, Gs, Gd^Fp, Gd^Fp
Ww, Ww, Ww, Gs, Gd^Fp, Gd^Fp, Ww, Gd^Fp, Ww, Gd^Fmf, Gd^Fmf, Gd^Fdf, Gd^Fdf, Gd^Fetd, Ss, Ss, Ss, Ss, Gd^Fdf, Gd^Fetd, Gd^Fdf, Gs^Fmf, Gs^Fp, Gs^Fp, Ww, Gd^Fp, Gs^Fp, Gs^Fp, Gd, Gd^Vhr, Gd^Fp, Gd^Fp
Gd^Fdf, Gll^Fdw, Gll^Fdw, Ww^Bw|, Ww, Ww, Ww, Ww, Gll^Fdw, Ww, Ww, Gd^Fdf, Ss, Ss, Gll^Feth, Ss, Gd^Fdf, Gs^Fet, Gd^Fdf, Gd^Fdf, Gd^Fdf, Gd^Fmf, Gd^Fmf, Gd^Fp, Ww, Ww, Ww, Gs^Fp, Gd^Fp, Gs, Gd^Fp, Gd^Fp
Gd^Fdf, Gll^Fdw, Gll^Fdw, Gs, Gs, Gll^Fdw, Gll^Fdw, Gll^Fdw, Gll^Fdw, Gll^Fdw, Gll^Fdw, Ww, Ww, Ss, Ss, Ss, Gd^Fmf, Gd^Fdf, Gd^Fdf, Gd^Fdf, Gd^Fmf, Hh^Fmf, Hh^Fmf, Gd^Fp, Gd^Fp, Ww, Ww, Gd^Fp, Gs, Gd^Fp, Gs^Fp, Gd^Fp
Gd^Fdf, Gd^Fdf, Gll^Fdw, Gll^Fdw, Gs, Gll^Fdw, Gll^Fdw, Gll^Fdw, Gll^Fdw, Gll^Fdw, Gll^Fdw, Gll^Fdw, Gd^Fp, Ww, Ss, Gd^Fmf, Gd^Fdf, Gd^Fdf, Gd^Fmf, Gd^Fmf, Gd^Fp, Hh^Fmf, Hh, Gd^Fp, Hh^Fp, Gd^Fp, Gd, Ww^Bw/, Ww, Gd^Fp, Gs^Fp, Gs^Fp
Gll^Fdw, Gd^Fdf, Gll^Fdw, Gll^Fdw, Gll^Fdw, Gs, Gs, Gll^Fdw, Gd^Fp, Gll^Fdw, Gd^Fp, Gd^Fp, Gd^Fp, Ww, Ww, Gd^Fmf, Gd^Fmf, Gd^Fdf, Gd^Fmf, Gd^Fmf, Gd^Fp, Hh, Gd, Gd, Hh, Hh^Fp, Gd, Gd^Fp, Ww, Gs^Fp, Gs^Fp, Gs^Fp
Gll^Fdw, Gd^Fdf, Gd^Fdf, Gll^Fdw, Gd^Fdf, Gll^Fdw, Gs, Gll^Fdw, Gd^Fp, Gd^Fp, Gd^Fp, Gd^Fp, Gd^Fp, Gd^Fp, Gd^Fp, Ww, Ww, Ww, Ww, Gd^Fp, Gd^Fmf, Gd^Fp, Hh^Fp, Hh, Hh^Fp, Gd^Fp, Gd^Fp, Gd^Fp, Ww, Ww, Ww, Ww
Gd^Fdf, Gd^Fdf, Gd^Fdf, Gd^Fdf, Gd^Fdf, Gd^Fdf, Gd, Gd^Fp, Gd^Fp, Gd^Fp, Gd^Fp, Gd^Fp, Gd^Fp, Gd^Fp, Gd^Fp, Gd^Fp, Gd^Fp, Gd^Fp, Ww, Ww, Ww, Gd^Fp, Ww, Hh^Fp, Gd^Fp, Gd^Fp, Gd, Gd^Fp, Ww, Ww, Ww, Ww
Gd^Fdf, Gd^Fdf, Gd^Fdf, Gd^Fdf, Gd^Fdf, Gd^Fdf, Gd^Fdf, Gd, Gd^Vhr, Gd^Fp, Gd^Fp, Gd^Fp, Gd^Fp, Gd^Fp, Gd^Fp, Gd^Fp, Gd^Fp, Gd^Fp, Gd^Fp, Gd^Fp, Gd^Fp, Ww, Ww, Ww, Ww, Ww, Ww^Bw|, Ww, Gll^Fdw, Ww, Gll^Fdw, Gll^Fdw
Gll^Fdw, Gd^Fdf, Gll^Fdw, Gd^Fdf, Gll^Fdw, Gd^Fdf, Gll^Fdw, Gd, Gd, Gd^Fp, Gd^Fp, Gd^Fp, Gd^Fp, Gd^Fp, Gd^Fp, Gd^Fp, Gd^Fp, Gd^Fp, Gd^Fp, Gd^Fp, Gd^Fp, Gd^Fp, Gd^Fp, Gd^Fp, Gd^Fp, Gs^Vc, Gd, Gll^Fdw, Gll^Fdw, Gll^Fdw, Gll^Fdw, Gll^Fdw
