Ms^Qhh, Ms^Qhh, Ms^Xm, Ms^Xm, Ms^Xm, Ms^Qhh, Ms^Qhh, Ms^Qhh, Ai^Qhh, Ms^Qhh, Ms^Qhh, Ms^Qhh, Ms^Qhh, Ms^Qhh, Ha^Qhh, Ms^Qhh, Ms^Qhh, Ms^Qhh, Ms^Qhh, Ms^Qhh, Ms^Qhh, Ha^Qhh, Ha^Qhh, Ha^Qhh, Aa, Aa, Rra, Rra, Aa, Aa, Aa, Ha^Qhh, Ha, Ha, Ha, Ha, Ha
Ms^Qhh, Ms, Ms, Ms^Xm, Ms, Ms, Ms, Ms, Ai, Ms, Ms, Ms, Ms, Ms, Ha, Ms, Ms, Ms^Xm, Ms, Ms, Ms, Ha, Ha^Qhh, Ha^Qhh, Aa, Aa, Rra, Rra, Aa, Aa, Aa, Ha^Qhh, Ha, Ha, Ha, Ha, Ha
Ha^Qhh, Ha, Ha, Ms, Ms, Ms, Ms, Ai, Ms, Ms, Ms, Ms, Ms, Ms, Ha^Vhha, Ms, Ms, Ms, Ms, Ms, Ms, Ha, Ha^Qhh, Aa, Ha^Qhh, Aa, Rra, Aa, Ai, Aa^Vha, Ha^Qhh, Ha^Qhh, Ha, Ha, Ms, Ms, Ms
Ha^Qhh, Ha, Ha, Ha, Ha, Ms, Ms, Ms, Ms, Ms, Ms, Ms, Ai, Ai, Ms, Ms, Ms, Ms, Ms, Ms, Ha, Ha, Ha, Ha^Qhh, Aa^Vha, Aa, Rra, Ai, Ai, Ai, Ha^Qhh, Ha, Ha, Ms, Ms^Xm, Ms, Ms
Ha^Qhh, Ha^Qhh, Ha^Qhh, Ha, Ha, Ha, Ha, Ha, Ha, Ha, Ai, Ai^_mh, Ha, Ms, Ms, Ms, Ms, Ms, Ha, Ha, Ha^Qhh, Ha, Hh^Qhh, Hh^Qhh, Rr, Rra, Ha^Qhh, Ha^Qhh, Ha^Qhh, Ha^Qhh, Ha, Ha, Ms, Ms, Ms, Ms^Xm, Ms^Xm
Aa, Aa, Ha^Qhh, Ha, Ha^Vhha, Ha, Ha, Ha, Ha^Qhh, Ai, Aa, Aa, Ha, Ms, Ms, Ms, Ms, Ms, Ha^Qhh, Ha^Qhh, Aa^Es, Ha^Qhh, Chr, Rb^Ecf, Rr, Cha, Cha, Ha^Qhh, Ha, Ha, Ha, Ms, Ms, Ms, Ms^Xm, Ms^Xm, Ms^Xm
Aa^Fpa, Aa^Fpa, Aa^Fpa, Ha^Qhh, Ha^Qhh, Ha^Qhh, Ha^Qhh, Ha^Qhh, Ai, Ai^Qhh, Ha^Qhh, Ha, Ha, Ms, Ms, Ms, Ms, Ms, Ha^Qhh, Aa, Aa, Ha^Qhh, Aa, Rr, Cha, 3 Kha, Ha^Qhh, Ha^Qhh, Ha, Ha, Ha, Ms, Ms, Ms, Ms, Ms^Xm, Ms^Xm
Aa^Fpa, Aa^Fpa, Aa^Fpa, Aa^Fpa, Aa^Fpa, Aa^Fda, Aa^Fda, Aa, Ai, Aa, Aa^Es, Ha^Qhh, Ha^Qhh, Ha, Ha, Ms, Ms^Qhh, Ha^Qhh, Aa^Fpa, Ha^Qhh, Aa, Aa, Rra, Rra, Aa^Fma, Cha, Ha^Qhh, Ha, Ha, Ha, Ha, Ms, Ms, Ms, Ha^Vhha, Ms, Ms
Aa^Fpa, Aa^Fpa, Aa^Fma, Aa^Fma, Aa^Fma, Aa^Fma, Aa^Fda, Aa, Ai, Ai, Aa, Ha^Qhh, Aa, Ha^Qhh, Ha^Qhh, Ms, Ms^Qhh, Aa^Fpa, Aa^Fpa, Aa^Fpa, Rra, Rra, Aa^Vha, Aa^Fpa, Aa^Fpa, Aa^Fma, Aa, Ha^Qhh, Ha^Qhh, Ha, Ha, Ha, Ms, Ai, Ai, Ai, Ai
Aa^Fpa, Aa^Fma, Aa^Fma, Aa^Fma, Aa^Fma, Aa^Fma, Aa^Fda, Aa, Aa, Ai, Aa, Aa, Aa^Vha, Aa, Ai, Ms^Qhh, Aa^Fma, Aa^Fpa, Aa^Fma, Aa^Fma, Rra, Aa, Aa, Aa^Fpa, Aa^Fma, Aa^Fma, Aa^Fma, Aa, Aa^Fda, Ha^Qhh, Ha^Qhh, Ha, Ai, Ai, Ms, Ms, Ms
Aa^Fpa, Aa^Fma, Aa^Fda, Ai, Cha, Aa^Fda, Aa, Aa, Ai, Ai, Ai, Aa, Ai, Ai, Aa, Aa^Fma, Aa^Fma, Aa^Fma, Aa^Fma, Rra, Aa, Aa, Ha, Ha, Ha, Ha, Ha, Aa^Fma, Aa^Fma, Aa^Fda, Ai, Ai^Qhh, Ha, Ha, Ha, Ms, Ms
Aa^Fma, Aa^Fma, Aa^Fda, Cha, 2 Kha, Cha, Aa, Ai, Ai, Wo, Wo, Ai, Aa, Aa, Aa, Aa, Aa^Vha, Aa^Fma, Rra, Rra, Aa, Ha, Ha, Ha, Ha, Ha, Ha, Aa^Fda, Aa^Fda, Aa^Fda, Ai, Ha^Qhh, Ha, Ha, Ha^_mh, Ha, Ha
Aa^Fda, Aa^Fma, Rb, Chr, Chr, Re, Re, Aa^Vha, Ai, Ai, Ai, Ai, Aa, Aa, Aa, Aa, Rra, Rra, Aa, Aa, Aa, Aa, Ha, Ha, Ha, Ha, Aa, Aa, Aa, Ai, Ha^Qhh, Ha^Qhh, Ha, Ha, Ha, Ha, Ha
Aa, Aa, Rb, Rb^Ecf, Ww, Ai, Ai, Ai^Bw\, Re, Aa, Aa, Ai, Aa, Aa, Aa, Aa, Rra, Rra, Rra, Aa^Es, Aa, Ha, Ha, Aa^Vha, Ai, Aa, Aa, Aa, Ai, Ai, Ha^Qhh, Ha, Ha, Ha, Ha^Qhh, Ha^Qhh, Ha^Qhh
Aa, Aa, Aa, Ww, Aa, Aa, Aa, Aa, Re, Aa, Aa, Aa, Re, Aa, Re^Esa, Rra, Aa, Aa, Rra, Aa, Aa, Aa, Aa, Ai, Ai, Aa, Aa^Vha, Aa^Fda, Ai, Aa^Fda, Aa^Fda, Ha^Qhh, Ha^Qhh, Ha^Qhh, Ai, Aa, Aa
Aa, Aa, Ai, Ai, Aa, Aa, Aa, Aa, Aa, Re, Re, Re, Aa^Vha, Re, Aa, Aa, Aa^Fda, Aa, Re^Esa, Aa^Vha, Aa, Aa, Ai, Ai, Wo, Ai, Ai, Ai, Aa^Fda, Aa^Fda, Aa^Fma, Aa, Aa, Aa, Aa^Fma, Aa, Aa
Ai, Ai, Aa, Aa, Aa, Aa, Aa, Aa, Aa, Aa, Aa, Aa, Ha, Ha, Ha, Aa^Fda, Aa^Fma, Aa^Fda, Re, Aa, Aa, Aa, Ai, Wo, Wo, Wo, Ai, Aa, Aa, Aa^Fda, Aa^Fda, Aa^Fma, Aa^Fma, Aa^Fma, Aa^Fma, Aa^Fma, Aa^Fma
Aa, Aa, Aa^Fma, Aa^Fma, Aa^Fma, Aa, Aa, Aa, Aa, Aa^Es, Aa, Aa, Ha, Ha, Ha, Aa^Fma, Aa^Fma, Aa^Fda, Re, Aa, Aa, Ai, Aa^Vha, Ai, Ai, Ai, Aa, Aa, Aa, Aa^Fda, Aa^Fma, Aa^Fda, Aa^Fma, Aa^Fma, Aa^Fma, Aa^Fma, Aa^Fma
Aa, Aa, Aa^Fma, Aa^Fma, Aa^Feta, Aa^Fma, Aa^Fma, Aa, Aa, Aa, Ha, Ha, Ha, Ha, Aa^Fma, Aa^Fma, Aa^Fma, Aa^Fda, Re, Aa, Aa, Aa, Aa, Aa, Aa, Ai, Aa^Vha, Aa, Aa, Aa^Fma, Aa^Fma, Aa^Fma, Aa^Fma, Aa^Vha, Aa^Fma, Aa^Fma, Aa^Fma
Aa, Aa, Aa^Fma, Aa^Fma, Aa^Fma, Aa^Fma, Aa^Fma, Aa^Vha, Aa, Ha, Ha, Ha, Ai, Ha, Aa^Fma, Aa^Fma, Aa^Fma, Aa^Fda, Re, Aa, Aa, Aa, Aa, Aa, Aa, Ai, Aa, Aa, Aa, Aa, Aa, Aa^Fma, Aa^Fma, Aa^Fma, Ai, Aa^Fma, Aa^Fma
Aa, Aa, Aa^Fma, Aa^Fma, Aa^Fma, Aa^Fma, Aa^Fma, Aa^Fma, Aa^Fma, Ha, Ha, Ha, Ha, Ha, Ha, Aa^Fma, Aa^Fda, Aa^Fda, Re, Aa, Aa^Fda, Aa^Fda, Aa^Fda, Aa, Aa, Ai, Aa, Aa^Fda, Aa^Fda, Aa, Aa, Aa^Fma, Aa^Fma, Ai, Ai, Aa, Aa
Aa^Fma, Aa^Fma, Aa^Fma, Aa^Fma, Aa^Fma, Aa^Vha, Aa^Fma, Aa^Fma, Aa^Fma, Aa, Aa, Aa, Aa, Ha, Ha, Aa, Aa, Aa, Re, Aa, Aa^Fda, Aa^Fda, Aa^Fda, Aa, Aa, Ai, Ai, Aa^Fda, Aa^Fda, Aa^Vha, Aa, Aa, Aa, Aa, Ai, Aa, Aa
Aa^Fma, Aa^Fma, Aa^Fda, Aa^Fma, Aa^Fma, Aa^Fma, Aa, Aa^Fma, Aa, Aa, Aa, Aa, Ha, Ha, Ha, Aa, Aa, Aa, Re, Aa, Aa^Fda, Aa^Fda, Re, Aa^Fda, Aa^Vha, Ai, Ai, Ai, Ai, Aa, Aa, Aa, Aa, Aa, Aa, Aa, Aa
Aa^Fda, Aa^Fda, Ai, Aa^Fda, Aa^Fma, Aa^Fma, Aa, Aa, Aa, Ai, Ai, Aa, Aa, Ha, Aa^Fda, Aa^Fda, Aa^Fda, Aa, Aa, Re, Re, Re, Aa^Fda, Re, Re, Aa, Aa, Aa, Ai, Aa, Re, Aa, Aa, Aa, Re, Aa, Aa
Aa^Fda, Aa^Fda, Ai, Aa^Fda, Aa, Aa, Aa^Vha, Aa, Aa, Ai, Ai, Aa, Aa^Fda, Aa^Fda, Aa^Fda, Aa^Fda, Aa^Fda, Aa^Fda, Aa, Re, Aa, Aa^Fda, Aa^Fda, Aa^Fda, Aa, Re, Re, Aa, Ai, Ai, Aa^Vha, Re, Re, Re, Aa, 1 Re, Re
Aa^Fda, Aa^Fda, Aa^Fda, Aa^Fda, Aa, Aa, Aa, Aa, Aa, Aa, Aa, Aa, Aa^Fda, Aa^Fda, Aa^Fda, Aa^Fda, Aa^Fda, Aa^Fda, Aa, Re, Aa^Vha, Aa^Fda, Aa^Fda, Aa^Fda, Aa^Fda, Aa^Fda, Re, Aa, Aa, Ww, Ww^Bw/r, Re, Aa, Aa, Aa, Aa, Aa
Aa^Fda, Aa^Fda, Aa^Fda, Aa^Fda, Aa, Aa, Ha, Ha, Ha, Aa^Es, Aa, Aa, Aa, Aa^Fda, Aa^Fda, Aa^Fda, Aa^Fda, Aa^Fda, Aa, Re, Aa, Aa^Fda, Aa^Fda, Aa^Fda, Aa^Fda, Aa^Fda, Aa^Fda, Re, Re, Re, Ww, Ww, Ww, Aa, Ww, Aa, Aa
Aa^Fda, Aa^Fda, Aa^Fda, Aa, Aa, Ha, Ha, Ha, Ha, Aa, Ha, Aa, Aa, Aa, Aa, Aa^Fda, Aa^Fda, Aa^Fda, Aa, Re, Aa, Aa, Aa^Fda, Aa^Fda, Aa^Fda, Aa^Fda, Aa, Aa, Aa, Aa^Vha, Ww, Ww, Ww, Ww, Ww, Ww, Ww
Aa^Fda, Aa^Fda, Aa^Fda, Aa^Fda, Aa, Ha, Ha, Ha, Ha, Ha, Ha, Ha, Ha, Aa^Vha, Ha, Ha, Ha, Aa, Re, Re, Aa^Fda, Aa^Fda, Aa^Fda, Aa^Fda, Aa^Fda, Aa, Ai, Aa, Aa, Aa, Ww, Ww, Ww, Ww, Ww, Ww, Ww
Aa^Fda, Aa^Fda, Aa^Fda, Aa^Fda, Ai, Aa, Ai, Ai, Ai, Ha, Ha, Ha, Ha, Ha, Ha, Ha, Ha, Aa, Re, Aa, Aa^Fda, Aa^Fda, Aa^Fda, Aa^Fda, Aa, Ai, Ai, Ai, Ww, Ww, Ww, Ww, Wo, Wo, Wo, Wo, Wo
Aa^Fda, Aa^Fda, Aa^Fda, Ai, Wo, Ai, Ai, Ai, Aa^Vha, Ha, Ha, Ai, Ha, Ha, Aa, Ha, Aa, Aa, Re, Aa, Aa, Aa^Fda, Aa^Fda, Aa^Fda, Aa, Ai, Ww, Ww, Ww, Ww, Wo, Ww, Wo, Wo, Wo, Wo, Wo
Aa^Fda, Aa^Fda, Aa^Fda, Ai, Ai, Wo, Ai, Aa, Ha, Ha, Ms, Ha, Ha, Ha, Re^Esa, Aa, Re, Re, Ha, Aa^Vha, Aa, Aa, Ai, Aa, Ww, Ww, Ww, Ww, Wo, Ww, Wo, Wo, Wo, Wo, Wo, Wo, Wo
Aa^Fda, Aa^Fda, Aa^Fda, Aa^Fda, Ai, Ai, Ha, Ha, Ms, Ms, Ms, Ms, Ms, Ms, Re, Re, Ha, Ha, Ha, Ha, Aa, Ai, Aa, Ai, Aa, Ww, Ww, Wo, Wo, Wo, Wo, Wo, Wo, Wo, Wo, Wo, Wo
Aa^Fda, Aa^Fda, Aa, Aa^Fda, Ai, Ha, Ha, Ha, Ha, Ha, Ms, Ms, Ha, Re, Ms, Ha, Ha, Ha, Aa, Aa^Es, Aa^Fda, Aa^Fda, Aa^Fda, Aa, Aa, Ww, Ww, Wo, Wo, Wo, Wo, Wo, Wo, Wo, Wo, Wo, Wo
Aa, Aa, Aa, Aa, Ai, Ha, Ha, Ha, Ha, Ms, Ms, Ms, Ms, Re, Ms, Ha, Ha, Ha, Ha, Aa, Aa^Fda, Aa, Aa^Fda, Aa^Vha, Ai, Ai, Ww, Ww, Wo, Wo, Wo, Wo, Wo, Wo, Wo, Wo, Wo
Aa, Aa, Aa^Vha, Aa, Ww, Ha, Ha, Ha, Ms, Ms, Ms, Ms, Cfr, Re, Ms, Ha, Ha, Ha, Ha, Aa^Fda, Aa^Fda, Aa^Fda, Aa^Fda, Aa, Ai, Ww, Ww, Ww, Wo, Wo, Wo, Wo, Wo, Wo, Wo, Wo, Wo
Ww, Ww, Ww, Ww, Aa, Aa, Ha, Ha, Ms, Ms, Ms, Cfa, 4 Kfr, Cfr, Ms, Ms, Ha, Ha, Aa^Vha, Ha, Aa, Aa^Fda, Ai, Ai, Ww, Ww, Ww, Wo, Wo, Wo, Wo, Wo, Wo, Wo, Wo, Wo, Wo
Ww, Ww, Ww, Ww, Aa, Aa, Aa, Ha, Ha, Ms, Ms, Cfr, Cfa, Cfa, Ms, Ms, Ha, Ha, Ha, Ha, Aa, Aa, Ai, Ww, Wo, Ww, Wo, Wo, Wo, Wo, Wo, Wo, Wo, Wo, Wo, Wo, Wo
Ww, Ww, Ww, Ww, Ai, Aa, Aa, Ha, Ha, Ha, Ha, Ms, Ms, Ms, Ms, Ms, Ha, Ha, Ha, Aa, Aa, Aa, Ai, Ww, Ww, Wo, Wo, Wo, Wo, Wo, Wo, Wo, Wo, Wo, Wo, Wo, Wo
Wo, Wo, Ww, Ww, Ai, Aa, Aa, Aa^Es, Ha, Ha, Ha, Ha, Ha, Ha, Aa^Vha, Ha, Aa, Ha, Aa, Aa, Ai, Ai, Ww, Ww, Ww, Wo, Wo, Wo, Wo, Wo, Wo, Wo, Wo, Wo, Wo, Wo, Wo
Wo, Wo, Ww, Ww, Ww, Ai, Aa, Aa, Aa, Ha, Ha, Ha, Aa, Aa^Fda, Aa^Fda, Aa^Fda, Aa^Fda, Aa, Aa, Aa, Ai, Ww, Ww, Ww, Wo, Wo, Wo, Wo, Wo, Wo, Wo, Wo, Wo, Wo, Wo, Wo, Wo
Wo, Wo, Wo, Wo, Ww, Ai, Ai, Aa, Ai, Aa, Aa^Vha, Aa, Aa, Aa^Fda, Aa^Fda, Aa^Fda, Aa^Fda, Aa^Fda, Aa, Ai, Ai, Ww, Ww, Wo, Wo, Wo, Wo, Wo, Wo, Wo, Wo, Wo, Wo, Wo, Wo, Wo, Wo
Wo, Wo, Wo, Wo, Wo, Ww, Ww, Ai, Ai, Aa, Aa, Aa, Ai, Aa, Ai, Aa, Ai, Aa, Ai, Ai, Ww, Ww, Wo, Wo, Wo, Wo, Wo, Wo, Wo, Wo, Wo, Wo, Wo, Wo, Wo, Wo, Wo
Wo, Wo, Wo, Wo, Wo, Wo, Ww, Ai, Ww, Ai, Ai, Ai, Ai, Ai, Ww, Ai, Ai, Ai, Ai, Ai, Ww, Ww, Wo, Wo, Wo, Wo, Wo, Wo, Wo, Wo, Wo, Wo, Wo, Wo, Wo, Wo, Wo
Wo, Wo, Wo, Wo, Wo, Ww, Ww, Ww, Ww, Ww, Ww, Ww, Ww, Ww, Wo, Ww, Ww, Ww, Ww, Ww, Ww, Ww, Wo, Wo, Wo, Wo, Wo, Wo, Wo, Wo, Wo, Wo, Wo, Wo, Wo, Wo, Wo
Wo, Wo, Wo, Wo, Wo, Wo, Wo, Wo, Wo, Ww, Wo, Ww, Wo, Wo, Wo, Ww, Wo, Ww, Wo, Wo, Wo, Wo, Wo, Wo, Wo, Wo, Wo, Wo, Wo, Wo, Wo, Wo, Wo, Wo, Wo, Wo, Wo
Wo, Wo, Wo, Wo, Wo, Wo, Wo, Wo, Wo, Wo, Wo, Wo, Wo, Wo, Wo, Wo, Wo, Wo, Wo, Wo, Wo, Wo, Wo, Wo, Wo, Wo, Wo, Wo, Wo, Wo, Wo, Wo, Wo, Wo, Wo, Wo, Wo
