Xoi, Xoi, Xoi, Xoi, Xoi, Xoi, Xoi, Xoi, Xoi, Xoi, Xoi, Xoi, Xoi, Xoi, Xoi, Xu, Xoi, Xu, Xu, Xu, Xoi, Xu, Xoi, Xoi, Xoi, Xoi, Xoi
Xoi, Xoi, Xoi, Xoi, Xoi, Xoi, Xoi, Xoi, Xoi, Xoi, Xoi, Xoi, Isa, Isa, Isa, Xoi, Isa, Xoi, Xoi, Xoi, Qxua, Xoi, Qxua, Xoi, Xoi, Xoi, Xoi
Xoi, Xoi, Xoi, Xoi, Xoi, Xoi, Xoi, Xoi, Isa, Isa, Uu^Vu, Isa, Isa, Isa, Isa, Isa, Uu^Vu, Isa, Isa, Qxua, Qxua, Qxua, Qxua, Qxua, Xoi, Xoi, Xoi
Xoi, Xoi, Xoi, Xoi, Xoi, Xoi, Isa, Isa, Qxu, Isa, Isa, Isa, Cud, Cud, Cud, Isa, Isa, Isa, Qxu, Isa, Isa, Qxua, Qxua, Qxua, Xoi, Xoi, Xoi
Xoi, Xoi, Xoi, Xoi, Qxu, Xoi, Uhe, Isa, Isa, Qxu, Isa, Isa, Cud, 2 Kud, Cud, Isa, Isa, Isa, Qxu, Isa, Isa, Qxua, Xoi, Xoi, Xoi, Xoi, Xoi
Xoi, Xoi, Xoi, Xoi, Qxu, Qxu, Uhe, Uhe, Isa, Qxu, Uu^Vu, Isa, Isa, Cud, Isa, Isa, Uu^Vu, Qxu, Isa, Isa, Isa, Xoi, Xoi, Xoi, Xoi, Xoi, Xoi
Xoi, Xoi, Urc, Urc, Qxu, Qxu, Uhe, Uhe, Isa, Isa, Isa, Isa, Isa, Isa, Isa, Isa, Uhe, Uhe, Isa, Uhe, Uhe, Xoi, Xoi, Xoi, Xoi, Xoi, Xoi
Xoi, Xoi, Urc, Urc, Qxu, Qxu, Qxu, Qxu, Isa, Isa, Isa, Xu, Xu, Xu, Xu, Xu, Isa, Isa, Isa, Xoi, Xoi, Xoi, Xoi, Xoi, Xoi, Xoi, Xoi
Xoi, Xoi, Urc, Xoi, Xoi, Xoi, Xoi, Uhe, Isa, Uhe, Isa, Isa, Isa, Isa, Isa, Isa, Uhe, Uhe, Isa, Isa, Xoi, Xoi, Xoi, Xoi, Xoi, Xoi, Xoi
Xoi, Xoi, Urc, Xoi, Xoi, Xoi, Xoi, Uhe, Isa, Qxu, Isa, Uhe, Uhe, Isa, Isa, Isa, Qxua, Qxua, Isa, Uhe, Xoi, Xoi, Xoi, Xoi, Xoi, Xoi, Xoi
Xoi, Xoi, Xoi, Urc, Urc, Xoi, Xoi, Isa, Isa, Isa, Xoi, Xoi, Uhe, Isa, Xoi, Isa, Uu^Vu, Qxua, Uhe, Uhe, Xoi, Xoi, Xof, Xoi, Xoi, Xoi, Xoi
Xoi, Xoi, Xoi, Xoi, Xoi, Urc, Urc, Xoi, Uu^Vu, Isa, Xoi, Uhe, Uhe, Isa, Xoi, Uh, Isa, Isa, Uu^Tf, Xoi, Xof, Xof, Ur, Xof, Xof, Xoi, Xoi
Xoi, Xoi, Xoi, Xoi, Xoi, Xoi, Xoi, Xoi, Xoi, Isa, Isa, Isa, Xoi, Xoi, Xoi, Xoi, Isa, Isa, Xoi, Xof, Ur, Ur, Urc, Ur, Ur, Xof, Xoi
Xoi, Xoi, Xoi, Xoi, Xoi, Xoi, Xoi, Xoi, Xoi, Uu^Tf, Isa, Isa, Xoi, Xoi, Xoi, Xoi, Isa, Isa, Xoi, Xof, Ur, Ur, Ur, Ur, Xof, Xof, Xoi
Xoi, Xoi, Xoi, Xoi, Xoi, Xoi, Uhe, Xoi, Isa, Isa, Ur, Isa, Ur, Uu, Uu^Tf, Ur, Ur, Isa, Isa, Rr^Pr\, Xoi, Xof, Xoi, Xof, Xoi, Xoi, Xoi
Xoi, Xoi, Xoi, Xoi, Xoi, Uu^Tf, Ur, Uu^Tf, Uu^Tf, Ur, Ww, Ww, Ww, Uu^Tf, Ww, Ww, Ww, Isa, Isa, Isa, Isa, Xoi, Isa, Xoi, Xoi, Xoi, Xoi
Xoi, Xoi, Wo, Wo, Wo, Ur, Ww^Bw\, Ww, Ww, Ww, Wo, Wo, Wo, Ww, Wo, Wo, Wo, Ww, Ww, Ww, Ww^Bw/, Isa, Wo, Xoi, Wo, Xoi, Xoi
Xoi, Xor, Xor, Xor, Ur, Ww, Uu^Tf, Ur, Uu^Tf, Ww, Ww, Wo, Ww, Wo, Ww, Wo, Ww, Ww, Uu^Tf, Ur, Ur, Ww, Ur, Wo, Xor, Xor, Xoi
Xor, Xor, Xoi, Xor, Ur, Ur, Uu^Vu, Ur, Ur, Uu^Tf, Uu^Tf, Ww, Uu^Tf, Ww, Uu^Tf, Ww, Uu^Tf, Uu^Tf, Ur, Ur, Uu^Vu, Ur, Ur, Xor, Xor, Xor, Xor
Xor, Xor, Xof, Xof, Rr^Pr\, Ur, Ur, Uu^Tf, Uu^Tf, Ur, Xu, Uu^Tf, Xu, Uu^Tfi, Xu, Uu^Tf, Xu, Ur, Ur, Ur, Uu^Tf, Uu^Tf, Xor, Xor, Xor, Xor, Xoi
Xor, Xor, Xof, Ur, Xof, Xor, Xor, Xor, Uu^Tf, Ur, Ur, Xu, Xu, Xu, Xu, Xu, Uhe, Ur, Ur, Xor, Xor, Xor, Xor, Xor, Xor, Xor, Xoi
Xor, Xof, Ur, Ur, Ur, Xof, Xor, Ur, Xu, Ur, Ur, Ur, Ur, Uu^Vu, Ur, Uhe, Ur, Ur, Xu, Uhe, Xor, Xoi, Xor, Xor, Xor, Xor, Xoi
Xor, Xof, Ur, Ur, Ur, Xof, Xor, Ur, Ur, Ur, Ur, Ur, Cud, Uu^Ii, Cud, Ur, Ur, Ur, Uhe, Uhe, Xor, Xor, Xor, Xor, Xor, Xor, Xoi
Xor, Xof, Ur, Urc, Ur, Xof, Xoi, Xor, Xor, Uu^Vu, Uhe, Ur, Cud, 1 Kud, Cud, Ur, Ur, Uu^Vu, Xor, Xor, Xor, Xor, Xor, Xor, Xor, Xor, Xoi
Xor, Xof, Xof, Ur, Xof, Xof, Xor, Xor, Xoi, Xor, Uhe, Uhe, Uhe, Cud, Uu, Uhe, Uhe, Xor, Xoi, Xor, Xor, Xor, Xor, Xor, Xoi, Xor, Xoi
Xor, Xor, Xor, Xof, Xor, Xor, Xor, Xor, Xor, Xor, Xor, Xor, Xor, Uhe, Xor, Xor, Xor, Xor, Xoi, Xoi, Xoi, Xor, Xoi, Xor, Xoi, Xoi, Xoi
Xoi, Xor, Xor, Xor, Xor, Xor, Xor, Xor, Xor, Xor, Xoi, Xor, Xoi, Uhe, Xor, Xor, Xor, Xor, Xor, Xor, Xoi, Xor, Xor, Xor, Xor, Xor, Xoi
